"","fips","Hillary Clinton","Donald Trump","Jill Stein","Gary Johnson","Third","diff"
"1","10001",33347,36989,1041,2876,3917,-3642
"2","10003",162905,85507,3955,9101,13056,77398
"3","10005",39329,62607,1104,2774,3878,-23278
"4","1001",5908,18110,105,538,643,-12202
"5","1003",18409,72780,453,2448,2901,-54371
"6","1005",4848,5431,18,93,111,-583
"7","1007",1874,6733,17,124,141,-4859
"8","1009",2150,22808,89,337,426,-20658
"9","1011",3530,1139,10,22,32,2391
"10","1013",3716,4891,13,65,78,-1175
"11","1015",13197,32803,262,1114,1376,-19606
"12","1017",5763,7803,44,168,212,-2040
"13","1019",1524,8809,25,145,170,-7285
"14","1021",2909,15068,52,226,278,-12159
"15","1023",3109,4102,6,51,57,-993
"16","1025",5712,7109,17,98,115,-1397
"17","1027",1234,5230,16,92,108,-3996
"18","1029",684,5738,20,90,110,-5054
"19","1031",4194,15825,102,392,494,-11631
"20","1033",7296,16718,106,506,612,-9422
"21","1035",3069,3413,10,51,61,-344
"22","1037",1780,3376,14,53,67,-1596
"23","1039",2379,13222,36,181,217,-10843
"24","1041",1663,4511,14,64,78,-2848
"25","1043",3730,32734,132,682,814,-29004
"26","1045",4408,13798,62,349,411,-9390
"27","1047",12826,5784,24,96,120,7042
"28","1049",3682,21779,156,469,625,-18097
"29","1051",8436,27619,112,738,850,-19183
"30","1053",4698,10282,38,195,233,-5584
"31","1055",10350,32132,163,829,992,-21782
"32","1057",1358,6705,24,109,133,-5347
"33","1059",2197,9466,54,238,292,-7269
"34","1061",1522,9967,23,147,170,-8445
"35","1063",4006,838,5,13,18,3168
"36","1065",4772,3172,12,54,66,1600
"37","1067",2286,5623,17,91,108,-3337
"38","1069",10547,30567,144,772,916,-20020
"39","1071",3663,16643,90,389,479,-12980
"40","1073",151581,130614,1509,6407,7916,20967
"41","1075",1035,5819,15,62,77,-4784
"42","1077",9877,27735,220,981,1201,-17858
"43","1079",3611,10732,31,249,280,-7121
"44","1081",20987,34321,362,1998,2360,-13334
"45","1083",9340,28824,200,1036,1236,-19484
"46","1085",4882,1751,11,32,43,3131
"47","1087",7237,1394,48,69,117,5843
"48","1089",62435,89199,1248,6591,7839,-26764
"49","1091",5607,5224,13,104,117,383
"50","1093",1432,11273,26,181,207,-9841
"51","1095",4913,29217,158,677,835,-24304
"52","1097",68429,91087,758,3113,3871,-22658
"53","1099",4310,5771,16,88,104,-1461
"54","11001",260223,11553,3995,4501,8496,248670
"55","1101",58669,33928,489,1486,1975,24741
"56","1103",11216,37392,218,1165,1383,-26176
"57","1105",3823,1403,6,23,29,2420
"58","1107",3972,5454,19,49,68,-1482
"59","1109",5039,7681,48,257,305,-2642
"60","1111",2290,7697,19,124,143,-5407
"61","1113",9577,9210,68,281,349,367
"62","1115",5550,31579,130,678,808,-26029
"63","1117",22927,72846,479,2956,3435,-49919
"64","1119",4739,1581,14,57,71,3158
"65","1121",12108,20596,105,409,514,-8488
"66","1123",5271,12967,49,217,266,-7696
"67","1125",31746,47701,390,1871,2261,-15955
"68","1127",4486,24208,95,454,549,-19722
"69","1129",2366,6031,22,73,95,-3665
"70","1131",4329,1737,7,22,29,2592
"71","1133",871,9225,29,130,159,-8354
"72","12001",75370,46584,1493,4032,5525,28786
"73","12003",2112,10294,30,169,199,-8182
"74","12005",21689,62010,561,2643,3204,-40321
"75","12007",2924,8913,47,177,224,-5989
"76","12009",119525,181620,2701,9435,12136,-62095
"77","12011",546956,258521,4992,10897,15889,288435
"78","12013",1236,4647,25,124,149,-3411
"79","12015",33421,60196,567,1944,2511,-26775
"80","12017",22765,54377,476,1722,2198,-31612
"81","12019",27768,74898,571,2805,3376,-47130
"82","12021",60941,105297,742,3256,3998,-44356
"83","12023",7599,20359,150,523,673,-12760
"84","12027",3761,6744,50,166,216,-2983
"85","12029",1270,5822,21,77,98,-4552
"86","12031",203627,210061,2874,11112,13986,-6434
"87","12033",57114,88370,1045,4554,5599,-31256
"88","12035",21985,33804,388,1111,1499,-11819
"89","12037",1738,4119,33,95,128,-2381
"90","12039",14994,6721,78,228,306,8273
"91","12041",1457,6740,43,154,197,-5283
"92","12043",1271,2996,18,54,72,-1725
"93","12045",1715,5320,27,195,222,-3605
"94","12047",1899,3439,17,79,96,-1540
"95","12049",2147,5238,24,140,164,-3091
"96","12051",4610,6192,52,206,258,-1582
"97","12053",31818,59029,710,2050,2760,-27211
"98","12055",14901,29509,186,850,1036,-14608
"99","12057",306422,265928,4994,15598,20592,40494
"100","12059",852,7476,19,133,152,-6624
"101","12061",28997,48564,417,1717,2134,-19567
"102","12063",6383,14231,59,266,325,-7848
"103","12065",3537,3930,42,110,152,-393
"104","12067",515,2795,10,47,57,-2280
"105","12069",62597,101888,970,3969,4939,-39291
"106","12071",124725,191141,2116,6967,9083,-66416
"107","12073",91936,53777,1360,4395,5755,38159
"108","12075",5091,13758,102,358,460,-8667
"109","12077",651,2542,17,76,93,-1891
"110","12079",3526,4849,22,95,117,-1323
"111","12081",71066,101681,1147,4169,5316,-30615
"112","12083",61958,107710,972,3361,4333,-45752
"113","12085",30158,53182,473,1803,2276,-23024
"114","12086",623006,333666,5965,13183,19148,289340
"115","12087",18949,21885,398,1129,1527,-2936
"116","12089",10849,34221,186,1192,1378,-23372
"117","12091",23711,71788,606,4155,4761,-48077
"118","12093",3953,9342,53,233,286,-5389
"119","12095",329579,195091,4769,14470,19239,134488
"120","12097",85287,50252,999,2810,3809,35035
"121","12099",371411,270762,3689,10229,13918,100649
"122","12101",89998,141943,1901,6122,8023,-51945
"123","12103",233327,238746,4595,13603,18198,-5419
"124","12105",117182,157216,1645,6798,8443,-40034
"125","12107",9920,21873,213,578,791,-11953
"126","12109",43037,88633,860,3608,4468,-45596
"127","12111",66812,70248,865,2471,3336,-3436
"128","12113",18398,65126,522,3094,3616,-46728
"129","12115",97676,124098,1591,4707,6298,-26422
"130","12117",105611,109265,1966,6793,8759,-3654
"131","12119",22631,52722,201,971,1172,-30091
"132","12121",3955,14281,80,307,387,-10326
"133","12123",2149,6923,33,150,183,-4774
"134","12125",1014,4567,12,90,102,-3553
"135","12127",108793,142763,2000,6103,8103,-33970
"136","12129",4348,10507,66,377,443,-6159
"137","12131",6861,25695,142,781,923,-18834
"138","12133",2261,8630,21,191,212,-6369
"139","13001",1434,5492,NA,77,NA,-4058
"140","13003",696,1873,NA,35,NA,-1177
"141","13005",607,3356,NA,47,NA,-2749
"142","13007",650,775,NA,15,NA,-125
"143","13009",7965,7691,NA,419,NA,274
"144","13011",684,6130,NA,132,NA,-5446
"145","13013",6580,21105,NA,1143,NA,-14525
"146","13015",8204,29879,NA,1180,NA,-21675
"147","13017",2098,3734,NA,91,NA,-1636
"148","13019",1041,5408,NA,114,NA,-4367
"149","13021",34383,22589,NA,1355,NA,11794
"150","13023",1094,3717,NA,123,NA,-2623
"151","13025",619,5561,NA,105,NA,-4942
"152","13027",2504,3679,NA,85,NA,-1175
"153","13029",4010,10513,NA,540,NA,-6503
"154","13031",8812,14476,NA,863,NA,-5664
"155","13033",4730,4491,NA,129,NA,239
"156","13035",2566,6717,NA,194,NA,-4151
"157","13037",1178,829,NA,16,NA,349
"158","13039",5914,12287,NA,624,NA,-6373
"159","13043",1023,2661,NA,73,NA,-1638
"160","13045",12422,29983,NA,1339,NA,-17561
"161","13047",4769,20860,NA,881,NA,-16091
"162","13049",1004,2950,NA,54,NA,-1946
"163","13051",58998,43649,NA,3366,NA,15349
"164","13053",593,746,NA,45,NA,-153
"165","13055",1612,6457,NA,177,NA,-4845
"166","13057",25203,80611,NA,5011,NA,-55408
"167","13059",29514,12691,NA,2016,NA,16823
"168","13061",697,566,NA,8,NA,131
"169","13063",75908,11740,NA,1588,NA,64168
"170","13065",685,1724,NA,34,NA,-1039
"171","13067",159416,152602,NA,14406,NA,6814
"172","13069",4090,9575,NA,231,NA,-5485
"173","13071",3460,9892,NA,240,NA,-6432
"174","13073",18863,43060,NA,2267,NA,-24197
"175","13075",1752,4175,NA,111,NA,-2423
"176","13077",16572,42513,NA,2230,NA,-25941
"177","13079",1419,3632,NA,106,NA,-2213
"178","13081",2835,4539,NA,126,NA,-1704
"179","13083",965,5047,NA,226,NA,-4082
"180","13085",1444,9880,NA,356,NA,-8436
"181","13087",4104,6009,NA,125,NA,-1905
"182","13089",239131,47531,NA,9209,NA,191600
"183","13091",1836,5021,NA,138,NA,-3185
"184","13093",1860,1941,NA,35,NA,-81
"185","13095",23224,10227,NA,474,NA,12997
"186","13097",30971,24803,NA,1591,NA,6168
"187","13099",2165,2552,NA,65,NA,-387
"188","13101",156,1006,NA,13,NA,-850
"189","13103",4851,17865,NA,679,NA,-13014
"190","13105",2507,5269,NA,136,NA,-2762
"191","13107",2433,5330,NA,75,NA,-2897
"192","13109",1130,2404,NA,68,NA,-1274
"193","13111",1920,9622,NA,222,NA,-7702
"194","13113",23255,35034,NA,2098,NA,-11779
"195","13115",9127,24045,NA,1078,NA,-14918
"196","13117",23427,69801,NA,4086,NA,-46374
"197","13119",1243,7054,NA,177,NA,-5811
"198","13121",281875,110372,NA,14926,NA,171503
"199","13123",1955,10465,NA,293,NA,-8510
"200","13125",138,1235,NA,17,NA,-1097
"201","13127",11738,21482,NA,821,NA,-9744
"202","13129",3176,15171,NA,503,NA,-11995
"203","13131",3005,6047,NA,135,NA,-3042
"204","13133",3194,5488,NA,149,NA,-2294
"205","13135",165063,146463,NA,12405,NA,18600
"206","13137",2483,13184,NA,461,NA,-10701
"207","13139",16153,51681,NA,2299,NA,-35528
"208","13141",2695,841,NA,36,NA,1854
"209","13143",1474,9579,NA,264,NA,-8105
"210","13145",4082,11931,NA,379,NA,-7849
"211","13147",2583,7285,NA,209,NA,-4702
"212","13149",743,3370,NA,93,NA,-2627
"213","13151",49902,45641,NA,2494,NA,4261
"214","13153",22460,35351,NA,1748,NA,-12891
"215","13155",890,2711,NA,58,NA,-1821
"216","13157",4469,21754,NA,834,NA,-17285
"217","13159",1544,4353,NA,119,NA,-2809
"218","13161",901,4102,NA,86,NA,-3201
"219","13163",3809,3057,NA,68,NA,752
"220","13165",1108,1892,NA,34,NA,-784
"221","13167",1136,2519,NA,27,NA,-1383
"222","13169",3960,8304,NA,260,NA,-4344
"223","13171",2267,5183,NA,125,NA,-2916
"224","13173",805,1984,NA,72,NA,-1179
"225","13175",6737,12401,NA,310,NA,-5664
"226","13177",3166,10641,NA,299,NA,-7475
"227","13179",9531,6125,NA,426,NA,3406
"228","13181",1271,2759,NA,70,NA,-1488
"229","13183",1356,2623,NA,130,NA,-1267
"230","13185",14614,21308,NA,891,NA,-6694
"231","13187",2216,9613,NA,495,NA,-7397
"232","13189",3699,5432,NA,137,NA,-1733
"233","13191",2298,3482,NA,113,NA,-1184
"234","13193",2705,1540,NA,42,NA,1165
"235","13195",2423,9195,NA,327,NA,-6772
"236","13197",1213,1921,NA,49,NA,-708
"237","13199",3800,5216,NA,165,NA,-1416
"238","13201",622,1888,NA,30,NA,-1266
"239","13205",3492,4272,NA,93,NA,-780
"240","13207",3570,8821,NA,284,NA,-5251
"241","13209",847,2668,NA,45,NA,-1821
"242","13211",2658,6559,NA,218,NA,-3901
"243","13213",1799,10340,NA,283,NA,-8541
"244","13215",39602,26901,NA,1817,NA,12701
"245","13217",21936,20907,NA,944,NA,1029
"246","13219",5253,12885,NA,892,NA,-7632
"247","13221",1829,4622,NA,199,NA,-2793
"248","13223",18004,44646,NA,1951,NA,-26642
"249","13225",5083,5405,NA,211,NA,-322
"250","13227",1977,11651,NA,354,NA,-9674
"251","13229",903,6301,NA,93,NA,-5398
"252","13231",1239,7273,NA,163,NA,-6034
"253","13233",2863,11006,NA,289,NA,-8143
"254","13235",1104,2436,NA,58,NA,-1332
"255","13237",2745,6516,NA,170,NA,-3771
"256","13239",461,575,NA,8,NA,-114
"257","13241",1443,6287,NA,219,NA,-4844
"258","13243",1597,1270,NA,28,NA,327
"259","13245",48707,24441,NA,1804,NA,24266
"260","13247",23206,13463,NA,920,NA,9743
"261","13249",401,1472,NA,36,NA,-1071
"262","13251",2300,3305,NA,94,NA,-1005
"263","13253",1186,2343,NA,48,NA,-1157
"264","13255",9347,15636,NA,957,NA,-6289
"265","13257",1835,7682,NA,243,NA,-5847
"266","13259",1220,805,NA,28,NA,415
"267","13261",5520,5275,NA,178,NA,245
"268","13263",2001,1196,NA,46,NA,805
"269","13265",545,349,NA,3,NA,196
"270","13267",1678,5092,NA,109,NA,-3414
"271","13269",1295,2062,NA,45,NA,-767
"272","13271",1313,2449,NA,32,NA,-1136
"273","13273",2267,1872,NA,40,NA,395
"274","13275",7138,11225,NA,367,NA,-4087
"275","13277",3892,8680,NA,224,NA,-4788
"276","13279",2338,6612,NA,158,NA,-4274
"277","13281",1206,5377,NA,143,NA,-4171
"278","13283",860,1808,NA,32,NA,-948
"279","13285",9597,15643,NA,553,NA,-6046
"280","13287",1243,2094,NA,53,NA,-851
"281","13289",1970,2034,NA,49,NA,-64
"282","13291",1962,9849,NA,228,NA,-7887
"283","13293",3471,7288,NA,165,NA,-3817
"284","13295",4213,18938,NA,788,NA,-14725
"285","13297",8279,31093,NA,1053,NA,-22814
"286","13299",3436,8508,NA,206,NA,-5072
"287","13301",1313,991,NA,28,NA,322
"288","13303",4187,4138,NA,97,NA,49
"289","13305",2039,8147,NA,190,NA,-6108
"290","13307",471,630,NA,13,NA,-159
"291","13309",646,1421,NA,35,NA,-775
"292","13311",1672,9751,NA,348,NA,-8079
"293","13313",7925,21514,NA,923,NA,-13589
"294","13315",852,2096,NA,25,NA,-1244
"295","13317",1844,2569,NA,57,NA,-725
"296","13319",1893,2332,NA,51,NA,-439
"297","13321",2015,6144,NA,107,NA,-4129
"298","15001",41258,17500,2852,2470,5322,23758
"299","15003",175634,90296,6467,10462,16929,85338
"300","15007",16456,7574,1019,982,2001,8882
"301","15009",33479,13445,2389,2035,4424,20034
"302","16001",75676,93748,3134,9978,13112,-18072
"303","16003",415,1556,19,83,102,-1141
"304","16005",10342,17180,518,1471,1989,-6838
"305","16007",255,2203,11,54,65,-1948
"306","16009",780,3101,42,151,193,-2321
"307","16011",2924,10907,124,417,541,-7983
"308","16013",6416,3340,176,424,600,3076
"309","16015",777,2673,35,173,208,-1896
"310","16017",5140,10220,347,626,973,-5080
"311","16019",8930,26699,399,1634,2033,-17769
"312","16021",933,3789,77,161,238,-2856
"313","16023",160,914,7,25,32,-754
"314","16025",110,410,15,23,38,-300
"315","16027",16683,46755,786,2748,3534,-30072
"316","16029",271,2275,15,64,79,-2004
"317","16031",1036,5949,37,202,239,-4913
"318","16033",44,203,1,4,5,-159
"319","16035",704,2852,38,97,135,-2148
"320","16037",427,1777,30,67,97,-1350
"321","16039",1814,5816,77,332,409,-4002
"322","16041",385,3901,30,117,147,-3516
"323","16043",651,4091,20,127,147,-3440
"324","16045",1229,5980,57,241,298,-4751
"325","16047",930,3743,30,110,140,-2813
"326","16049",1196,6441,52,249,301,-5245
"327","16051",976,8436,55,274,329,-7460
"328","16053",2117,7347,81,334,415,-5230
"329","16055",16264,44449,744,2604,3348,-28185
"330","16057",8093,7255,463,1197,1660,838
"331","16059",733,3011,31,135,166,-2278
"332","16061",270,1202,13,62,75,-932
"333","16063",360,1184,18,54,72,-824
"334","16065",1201,8941,69,612,681,-7740
"335","16067",1167,4887,41,207,248,-3720
"336","16069",4828,10699,203,879,1082,-5871
"337","16071",184,1531,3,37,40,-1347
"338","16073",591,3052,26,108,134,-2461
"339","16075",892,4306,48,187,235,-3414
"340","16077",699,1666,26,92,118,-967
"341","16079",1384,3297,54,219,273,-1913
"342","16081",2157,2161,99,183,282,-4
"343","16083",6844,21063,334,1126,1460,-14219
"344","16085",1913,2906,53,230,283,-993
"345","16087",776,3283,26,138,164,-2507
"346","17001",7633,22732,248,1157,1405,-15099
"347","17003",1262,1496,14,48,62,-234
"348","17005",2066,4884,66,446,512,-2818
"349","17007",8952,12261,329,1062,1391,-3309
"350","17009",475,1776,10,75,85,-1301
"351","17011",6010,9264,193,836,1029,-3254
"352","17013",739,1719,26,72,98,-980
"353","17015",2437,4428,96,393,489,-1991
"354","17017",1617,3216,50,171,221,-1599
"355","17019",49694,33235,1765,4502,6267,16459
"356","17021",3982,10522,147,659,806,-6540
"357","17023",1873,5620,49,277,326,-3747
"358","17025",1014,5009,48,207,255,-3995
"359","17027",3939,12394,124,811,935,-8455
"360","17029",7285,12985,287,1023,1310,-5700
"361","17031",1528582,440213,30520,55900,86420,1088369
"362","17033",1969,6146,68,324,392,-4177
"363","17035",1028,4200,47,238,285,-3172
"364","17037",20348,19051,743,2463,3206,1297
"365","17039",1907,5072,61,429,490,-3165
"366","17041",1946,5695,89,359,448,-3749
"367","17043",222499,164355,6173,19902,26075,58144
"368","17045",1778,5634,47,324,371,-3856
"369","17047",432,2777,12,91,103,-2345
"370","17049",3071,13613,100,644,744,-10542
"371","17051",1814,7363,57,281,338,-5549
"372","17053",1410,4474,86,319,405,-3064
"373","17055",4711,13101,183,538,721,-8390
"374","17057",6118,8482,236,773,1009,-2364
"375","17059",656,1942,20,73,93,-1286
"376","17061",1202,4139,39,162,201,-2937
"377","17063",8021,13417,322,1131,1453,-5396
"378","17065",800,3205,24,114,138,-2405
"379","17067",1744,5713,55,306,361,-3969
"380","17069",419,1650,18,46,64,-1231
"381","17071",1151,2153,19,157,176,-1002
"382","17073",8835,13962,198,1237,1435,-5127
"383","17075",2496,9728,149,550,699,-7232
"384","17077",11619,10889,803,1198,2001,730
"385","17079",924,3973,26,181,207,-3049
"386","17081",4408,11681,158,571,729,-7273
"387","17083",2673,7737,94,405,499,-5064
"388","17085",4452,6113,116,496,612,-1661
"389","17087",1135,4644,56,182,238,-3509
"390","17089",99389,82087,2835,9189,12024,17302
"391","17091",18908,25081,585,1982,2567,-6173
"392","17093",23392,24152,721,2550,3271,-760
"393","17095",9939,10658,273,1094,1367,-719
"394","17097",168186,108608,3732,13048,16780,59578
"395","17099",19277,26269,637,2264,2901,-6992
"396","17101",1288,4517,41,193,234,-3229
"397","17103",5499,8597,226,893,1119,-3098
"398","17105",4005,10197,125,769,894,-6192
"399","17107",3301,8167,129,533,662,-4866
"400","17109",5278,6789,209,634,843,-1511
"401","17111",59827,71117,2118,7083,9201,-11290
"402","17113",35918,37081,1193,4803,5996,-1163
"403","17115",18211,26782,454,1836,2290,-8571
"404","17117",6532,14194,238,917,1155,-7662
"405","17119",50336,70295,1831,5440,7271,-19959
"406","17121",4231,11677,158,534,692,-7446
"407","17123",1784,3776,78,265,343,-1992
"408","17125",2008,4051,54,320,374,-2043
"409","17127",1555,4844,40,194,234,-3289
"410","17129",1808,4230,74,311,385,-2422
"411","17131",3061,4800,82,474,556,-1739
"412","17133",5522,12614,200,738,938,-7092
"413","17135",3490,8616,128,595,723,-5126
"414","17137",4693,9060,187,667,854,-4367
"415","17139",1476,4453,43,237,280,-2977
"416","17141",8025,14344,274,1155,1429,-6319
"417","17143",37436,35299,1065,3665,4730,2137
"418","17145",2433,6816,112,345,457,-4383
"419","17147",2633,5623,86,557,643,-2990
"420","17149",1412,5749,40,257,297,-4337
"421","17151",374,1678,18,62,80,-1304
"422","17153",817,1583,19,54,73,-766
"423","17155",1143,1762,35,136,171,-619
"424","17157",3421,9992,134,485,619,-6571
"425","17159",1579,5736,81,234,315,-4157
"426","17161",32258,26969,732,3012,3744,5289
"427","17163",60180,53479,1442,4100,5542,6701
"428","17165",2551,8248,77,358,435,-5697
"429","17167",40731,49823,1434,4484,5918,-9092
"430","17169",1074,2523,41,154,195,-1449
"431","17171",528,1965,22,68,90,-1437
"432","17173",2279,8209,55,369,424,-5930
"433","17175",748,1777,33,149,182,-1029
"434","17177",7531,10845,241,908,1149,-3314
"435","17179",20568,38620,823,3336,4159,-18052
"436","17181",2389,5780,126,219,345,-3391
"437","17183",9876,18582,281,1060,1341,-8706
"438","17185",1146,4039,42,175,217,-2893
"439","17187",2983,4267,92,358,450,-1284
"440","17189",1446,5566,75,289,364,-4120
"441","17191",1048,6963,55,190,245,-5915
"442","17193",1412,5639,34,204,238,-4227
"443","17195",11005,12597,325,1283,1608,-1592
"444","17197",146230,129726,3717,11337,15054,16504
"445","17199",8539,21503,394,986,1380,-12964
"446","17201",52595,53922,1632,4878,6510,-1327
"447","17203",5068,13180,213,928,1141,-8112
"448","18001",2802,9642,NA,595,NA,-6840
"449","18003",55222,83801,NA,6764,NA,-28579
"450","18005",9841,20637,NA,1911,NA,-10796
"451","18007",860,2579,NA,215,NA,-1719
"452","18009",1243,3349,NA,230,NA,-2106
"453","18011",10181,19654,NA,2226,NA,-9473
"454","18013",2518,5015,NA,375,NA,-2497
"455","18015",1891,6273,NA,445,NA,-4382
"456","18017",3758,9697,NA,680,NA,-5939
"457","18019",18791,30012,NA,2301,NA,-11221
"458","18021",2306,8528,NA,425,NA,-6222
"459","18023",2819,8530,NA,547,NA,-5711
"460","18025",1323,3013,NA,255,NA,-1690
"461","18027",1800,8545,NA,391,NA,-6745
"462","18029",4883,18110,NA,917,NA,-13227
"463","18031",2121,8488,NA,486,NA,-6367
"464","18033",3941,12054,NA,821,NA,-8113
"465","18035",18100,24217,NA,2382,NA,-6117
"466","18037",5389,13365,NA,1163,NA,-7976
"467","18039",20667,41810,NA,2710,NA,-21143
"468","18041",2252,6839,NA,439,NA,-4587
"469","18043",13939,21427,NA,1859,NA,-7488
"470","18045",1476,5661,NA,337,NA,-4185
"471","18047",1967,8665,NA,358,NA,-6698
"472","18049",1960,6010,NA,404,NA,-4050
"473","18051",3720,11079,NA,673,NA,-7359
"474","18053",7029,17009,NA,1201,NA,-9980
"475","18055",2929,10275,NA,559,NA,-7346
"476","18057",57214,87299,NA,9117,NA,-30085
"477","18059",8901,25050,NA,2076,NA,-16149
"478","18061",4776,12993,NA,759,NA,-8217
"479","18063",22595,48326,NA,4337,NA,-25731
"480","18065",5124,13895,NA,1056,NA,-8771
"481","18067",11215,23675,NA,1864,NA,-12460
"482","18069",3506,11649,NA,819,NA,-8143
"483","18071",3843,12857,NA,832,NA,-9014
"484","18073",3329,9382,NA,620,NA,-6053
"485","18075",1889,5697,NA,376,NA,-3808
"486","18077",4325,8538,NA,598,NA,-4213
"487","18079",2364,8222,NA,529,NA,-5858
"488","18081",17318,45456,NA,3455,NA,-28138
"489","18083",3772,11077,NA,634,NA,-7305
"490","18085",6311,23909,NA,1687,NA,-17598
"491","18087",2080,7025,NA,447,NA,-4945
"492","18089",116896,75565,NA,7786,NA,41331
"493","18091",19795,22678,NA,2521,NA,-2883
"494","18093",4210,14034,NA,832,NA,-9824
"495","18095",18595,32376,NA,2689,NA,-13781
"496","18097",212676,130228,NA,18166,NA,82448
"497","18099",4798,12286,NA,924,NA,-7488
"498","18101",881,3695,NA,231,NA,-2814
"499","18103",2766,9975,NA,699,NA,-7209
"500","18105",34183,20527,NA,2913,NA,13656
"501","18107",3362,11051,NA,688,NA,-7689
"502","18109",6037,23671,NA,1472,NA,-17634
"503","18111",1403,4074,NA,314,NA,-2671
"504","18113",3904,12198,NA,788,NA,-8294
"505","18115",686,2118,NA,113,NA,-1432
"506","18117",2048,5800,NA,341,NA,-3752
"507","18119",1946,6151,NA,423,NA,-4205
"508","18121",1441,4863,NA,272,NA,-3422
"509","18123",3062,4556,NA,407,NA,-1494
"510","18125",1297,4398,NA,282,NA,-3101
"511","18127",33531,38719,NA,4242,NA,-5188
"512","18129",3515,8393,NA,540,NA,-4878
"513","18131",1327,3854,NA,256,NA,-2527
"514","18133",3356,10637,NA,687,NA,-7281
"515","18135",2446,7515,NA,495,NA,-5069
"516","18137",2471,9806,NA,513,NA,-7335
"517","18139",1525,5292,NA,397,NA,-3767
"518","18141",52247,52019,NA,5186,NA,228
"519","18143",2642,6074,NA,344,NA,-3432
"520","18145",4247,12718,NA,970,NA,-8471
"521","18147",2861,6572,NA,526,NA,-3711
"522","18149",2489,6367,NA,370,NA,-3878
"523","18151",3741,10127,NA,662,NA,-6386
"524","18153",2113,6138,NA,308,NA,-4025
"525","18155",930,2558,NA,151,NA,-1628
"526","18157",27207,30711,NA,3998,NA,-3504
"527","18159",1587,5589,NA,334,NA,-4002
"528","18161",715,2445,NA,126,NA,-1730
"529","18163",28296,40422,NA,3239,NA,-12126
"530","18165",2081,4511,NA,321,NA,-2430
"531","18167",15922,21924,NA,1723,NA,-6002
"532","18169",3018,9819,NA,578,NA,-6801
"533","18171",839,2896,NA,184,NA,-2057
"534","18173",9086,19133,NA,1390,NA,-10047
"535","18175",2636,8206,NA,491,NA,-5570
"536","18177",8322,16028,NA,1225,NA,-7706
"537","18179",2585,9999,NA,539,NA,-7414
"538","18181",2563,6813,NA,526,NA,-4250
"539","18183",3379,11357,NA,799,NA,-7978
"540","19001",1127,2456,13,125,138,-1329
"541","19003",565,1393,9,93,102,-828
"542","19005",2409,4072,46,224,270,-1663
"543","19007",1813,4031,42,139,181,-2218
"544","19009",1079,2135,24,106,130,-1056
"545","19011",4672,8226,86,540,626,-3554
"546","19013",32006,27382,601,2357,2958,4624
"547","19015",5517,7458,104,643,747,-1941
"548","19017",5349,7199,81,543,624,-1850
"549","19019",3966,5504,54,478,532,-1538
"550","19021",2851,4895,47,287,334,-2044
"551","19023",2163,4918,43,217,260,-2755
"552","19025",1396,3466,18,172,190,-2070
"553","19027",3305,6627,58,317,375,-3322
"554","19029",1946,4755,52,206,258,-2809
"555","19031",3578,5275,70,362,432,-1697
"556","19033",9840,11583,128,843,971,-1743
"557","19035",1676,4188,29,206,235,-2512
"558","19037",2264,3739,48,236,284,-1475
"559","19039",1463,2706,18,159,177,-1243
"560","19041",2246,5870,35,286,321,-3624
"561","19043",3236,5309,50,384,434,-2073
"562","19045",10079,11249,183,819,1002,-1170
"563","19047",1985,4608,33,172,205,-2623
"564","19049",15662,19288,181,1749,1930,-3626
"565","19051",976,2721,25,85,110,-1745
"566","19053",1201,2296,29,123,152,-1095
"567","19055",2956,5688,40,337,377,-2732
"568","19057",8178,9479,132,633,765,-1301
"569","19059",3051,6743,54,291,345,-3692
"570","19061",22774,23384,87,374,461,-610
"571","19063",1356,3121,26,138,164,-1765
"572","19065",3666,5591,62,326,388,-1925
"573","19067",3177,4371,60,241,301,-1194
"574","19069",1490,3153,31,187,218,-1663
"575","19071",959,2401,21,115,136,-1442
"576","19073",1688,2819,31,160,191,-1131
"577","19075",1847,4516,38,233,271,-2669
"578","19077",1720,3603,18,256,274,-1883
"579","19079",2715,4450,31,259,290,-1735
"580","19081",1582,3972,22,165,187,-2390
"581","19083",2774,5231,28,294,322,-2457
"582","19085",2123,4892,50,209,259,-2769
"583","19087",2897,5764,113,336,449,-2867
"584","19089",1674,2611,38,130,168,-937
"585","19091",1251,3564,20,127,147,-2313
"586","19093",792,2655,9,103,112,-1863
"587","19095",3070,5193,61,315,376,-2123
"588","19097",3837,5821,85,318,403,-1984
"589","19099",7108,10556,95,715,810,-3448
"590","19101",3702,3738,255,246,501,-36
"591","19103",49942,20993,874,2743,3617,28949
"592","19105",3779,5718,62,305,367,-1939
"593","19107",1265,3385,28,139,167,-2120
"594","19109",2529,5637,33,193,226,-3108
"595","19111",6195,8762,145,502,647,-2567
"596","19113",58481,48183,994,5510,6504,10298
"597","19115",1643,3060,28,134,162,-1417
"598","19117",1236,2873,28,115,143,-1637
"599","19119",917,5188,18,137,155,-4271
"600","19121",2666,5336,41,344,385,-2670
"601","19123",2606,7404,38,316,354,-4798
"602","19125",5469,10940,73,703,776,-5471
"603","19127",7623,9125,117,576,693,-1502
"604","19129",2080,5050,56,303,359,-2970
"605","19131",1879,3180,28,209,237,-1301
"606","19133",1244,3115,22,112,134,-1871
"607","19135",1053,2635,13,104,117,-1582
"608","19137",1312,3431,38,152,190,-2119
"609","19139",8284,9549,180,741,921,-1265
"610","19141",1314,5735,27,195,222,-4421
"611","19143",552,2528,10,73,83,-1976
"612","19145",1801,4875,37,174,211,-3074
"613","19147",1395,3079,20,131,151,-1684
"614","19149",2878,9659,52,342,394,-6781
"615","19151",962,2692,14,115,129,-1730
"616","19153",119671,93421,1734,10009,11743,26250
"617","19155",15341,24441,327,1467,1794,-9100
"618","19157",4272,4936,72,281,353,-664
"619","19159",753,1820,8,72,80,-1067
"620","19161",1269,3692,23,129,152,-2423
"621","19163",40302,39083,782,3547,4329,1219
"622","19165",1649,4340,28,174,202,-2691
"623","19167",2289,14761,53,431,484,-12472
"624","19169",25085,19111,475,2963,3438,5974
"625","19171",3194,4968,79,244,323,-1774
"626","19173",755,2108,10,97,107,-1353
"627","19175",1920,3521,52,212,264,-1601
"628","19177",843,2524,19,83,102,-1681
"629","19179",5591,8710,121,380,501,-3119
"630","19181",10371,14773,122,1270,1392,-4402
"631","19183",3938,6170,79,458,537,-2232
"632","19185",719,2069,17,78,95,-1350
"633","19187",6293,10049,113,568,681,-3756
"634","19189",1920,3437,34,218,252,-1517
"635","19191",5238,5332,99,381,480,-94
"636","19193",16102,24627,323,1173,1496,-8525
"637","19195",1523,2443,24,165,189,-920
"638","19197",1890,3790,35,175,210,-1900
"639","20001",1398,3575,118,223,341,-2177
"640","20003",665,2386,80,146,226,-1721
"641","20005",1946,3977,160,310,470,-2031
"642","20007",281,1822,28,78,106,-1541
"643","20009",1823,7766,155,344,499,-5943
"644","20011",1306,4314,106,192,298,-3008
"645","20013",850,2861,97,152,249,-2011
"646","20015",6489,18781,390,1391,1781,-12292
"647","20017",313,964,23,42,65,-651
"648","20019",236,1552,27,30,57,-1316
"649","20021",1959,6017,123,287,410,-4058
"650","20023",188,1172,20,29,49,-984
"651","20025",118,813,19,33,52,-695
"652","20027",665,2831,85,146,231,-2166
"653","20029",744,2856,74,157,231,-2112
"654","20031",719,2990,68,185,253,-2271
"655","20033",102,705,10,40,50,-603
"656","20035",3436,8016,264,455,719,-4580
"657","20037",5064,8394,300,646,946,-3330
"658","20039",178,1220,20,42,62,-1042
"659","20041",1582,5905,160,361,521,-4323
"660","20043",584,2601,56,125,181,-2017
"661","20045",30089,14308,1485,2349,3834,15781
"662","20047",208,1033,34,33,67,-825
"663","20049",160,1048,16,35,51,-888
"664","20051",2669,8311,226,454,680,-5642
"665","20053",515,1933,73,105,178,-1418
"666","20055",3006,6155,174,396,570,-3149
"667","20057",2032,4994,129,270,399,-2962
"668","20059",2829,7025,258,546,804,-4196
"669","20061",2569,4116,145,299,444,-1547
"670","20063",149,1127,12,40,52,-978
"671","20065",185,1013,29,38,67,-828
"672","20067",427,1755,31,98,129,-1328
"673","20069",257,1651,30,73,103,-1394
"674","20071",83,523,8,25,33,-440
"675","20073",484,2146,59,122,181,-1662
"676","20075",114,690,13,30,43,-576
"677","20077",388,1950,60,115,175,-1562
"678","20079",5006,8503,358,673,1031,-3497
"679","20081",228,1011,21,40,61,-783
"680","20083",124,845,16,21,37,-721
"681","20085",1489,3888,139,211,350,-2399
"682","20087",2483,5112,181,375,556,-2629
"683","20089",180,1204,43,56,99,-1024
"684","20091",126324,133907,4849,14673,19522,-7583
"685","20093",224,1048,13,40,53,-824
"686","20095",594,2507,68,112,180,-1913
"687","20097",111,855,15,42,57,-744
"688","20099",2234,5232,162,291,453,-2998
"689","20101",104,684,12,31,43,-580
"690","20103",10064,17387,645,1580,2225,-7323
"691","20105",214,1168,27,39,66,-954
"692","20107",721,3377,65,116,181,-2656
"693","20109",149,1124,28,47,75,-975
"694","20111",4456,6354,312,623,935,-1898
"695","20113",3183,8407,287,566,853,-5224
"696","20115",1177,3928,139,221,360,-2751
"697","20117",1060,3250,72,196,268,-2190
"698","20119",206,1390,18,61,79,-1184
"699","20121",3949,9839,257,667,924,-5890
"700","20123",469,2216,53,86,139,-1747
"701","20125",2557,8466,205,395,600,-5909
"702","20127",586,1790,60,132,192,-1204
"703","20129",145,970,13,32,45,-825
"704","20131",714,4066,82,163,245,-3352
"705","20133",1464,4340,115,232,347,-2876
"706","20135",160,1216,20,39,59,-1056
"707","20137",277,1808,40,65,105,-1531
"708","20139",1730,4713,162,289,451,-2983
"709","20141",231,1437,40,45,85,-1206
"710","20143",424,2261,42,139,181,-1837
"711","20145",567,1872,34,129,163,-1305
"712","20147",296,2200,29,86,115,-1904
"713","20149",2191,7451,185,532,717,-5260
"714","20151",769,2824,50,163,213,-2055
"715","20153",160,1209,26,53,79,-1049
"716","20155",6670,15100,439,1239,1678,-8430
"717","20157",370,1993,41,80,121,-1623
"718","20159",668,2652,65,182,247,-1984
"719","20161",8892,9817,386,1380,1766,-925
"720","20163",273,1999,29,77,106,-1726
"721","20165",227,1177,17,53,70,-950
"722","20167",454,2544,43,107,150,-2090
"723","20169",6084,13367,445,1310,1755,-7283
"724","20171",232,1832,26,69,95,-1600
"725","20173",66716,101319,3850,8865,12715,-34603
"726","20175",1491,3025,55,172,227,-1534
"727","20177",33270,35349,1698,3331,5029,-2079
"728","20179",126,1186,12,38,50,-1060
"729","20181",340,2043,45,109,154,-1703
"730","20183",295,1635,29,55,84,-1340
"731","20185",303,1485,34,62,96,-1182
"732","20187",132,580,8,22,30,-448
"733","20189",215,1564,25,49,74,-1349
"734","20191",2039,6844,199,412,611,-4805
"735","20193",467,2832,55,129,184,-2365
"736","20195",193,1211,17,38,55,-1018
"737","20197",773,2358,69,140,209,-1585
"738","20199",45,711,8,15,23,-666
"739","20201",378,2136,45,118,163,-1758
"740","20203",139,765,12,18,30,-626
"741","20205",550,2747,55,130,185,-2197
"742","20207",270,1063,24,63,87,-793
"743","20209",29346,15520,919,1682,2601,13826
"744","21001",1323,6637,35,141,176,-5314
"745","21003",1349,6466,46,161,207,-5117
"746","21005",2634,8242,54,319,373,-5608
"747","21007",816,3161,20,77,97,-2345
"748","21009",4275,13483,93,455,548,-9208
"749","21011",1361,3082,24,75,99,-1721
"750","21013",1720,7764,42,144,186,-6044
"751","21015",15026,39082,380,2299,2679,-24056
"752","21017",2791,5569,52,283,335,-2778
"753","21019",6021,13591,167,496,663,-7570
"754","21021",4281,8040,73,365,438,-3759
"755","21023",705,2711,20,51,71,-2006
"756","21025",1537,3991,35,117,152,-2454
"757","21027",1960,6484,47,194,241,-4524
"758","21029",8255,26210,253,964,1217,-17955
"759","21031",947,4428,11,136,147,-3481
"760","21033",1260,4507,32,118,150,-3247
"761","21035",4749,10367,150,492,642,-5618
"762","21037",14658,25050,422,1789,2211,-10392
"763","21039",432,2094,12,42,54,-1662
"764","21041",1106,2588,24,100,124,-1482
"765","21043",2276,7587,58,237,295,-5311
"766","21045",767,5482,28,121,149,-4715
"767","21047",7188,14108,120,474,594,-6920
"768","21049",4706,10710,121,453,574,-6004
"769","21051",752,5861,26,83,109,-5109
"770","21053",547,3809,15,60,75,-3262
"771","21055",617,3290,17,76,93,-2673
"772","21057",459,2502,11,67,78,-2043
"773","21059",14163,28907,453,1488,1941,-14744
"774","21061",979,4135,20,77,97,-3156
"775","21063",740,2000,19,67,86,-1260
"776","21065",1108,4236,30,129,159,-3128
"777","21067",69776,56890,1580,5230,6810,12886
"778","21069",1348,4722,20,109,129,-3374
"779","21071",4015,11993,56,357,413,-7978
"780","21073",10717,11819,236,725,961,-1102
"781","21075",774,1549,7,35,42,-775
"782","21077",749,2443,18,100,118,-1694
"783","21079",1453,5904,33,157,190,-4451
"784","21081",1910,7268,71,226,297,-5358
"785","21083",3308,12671,80,411,491,-9363
"786","21085",1959,8219,46,259,305,-6260
"787","21087",832,4372,24,84,108,-3540
"788","21089",4146,11546,109,319,428,-7400
"789","21091",1244,2788,44,129,173,-1544
"790","21093",13944,26970,346,1413,1759,-13026
"791","21095",1372,9129,39,156,195,-7757
"792","21097",2031,5435,46,184,230,-3404
"793","21099",1730,5320,39,140,179,-3590
"794","21101",6707,12159,142,507,649,-5452
"795","21103",1828,4944,58,224,282,-3116
"796","21105",449,1657,6,26,32,-1208
"797","21107",4310,15277,97,478,575,-10967
"798","21109",482,4889,20,79,99,-4407
"799","21111",190824,143758,3224,10187,13411,47066
"800","21113",6144,15474,170,829,999,-9330
"801","21115",1250,8043,60,163,223,-6793
"802","21117",24213,42958,703,3093,3796,-18745
"803","21119",1245,4357,13,102,115,-3112
"804","21121",1761,9885,64,189,253,-8124
"805","21123",1278,4799,28,174,202,-3521
"806","21125",3440,20592,114,473,587,-17152
"807","21127",1045,4816,32,107,139,-3771
"808","21129",444,2151,7,42,49,-1707
"809","21131",400,4015,15,39,54,-3615
"810","21133",1542,7293,37,210,247,-5751
"811","21135",785,4363,16,95,111,-3578
"812","21137",1865,7338,44,226,270,-5473
"813","21139",887,3570,24,115,139,-2683
"814","21141",2755,7778,43,229,272,-5023
"815","21143",1045,2789,15,74,89,-1744
"816","21145",9134,20774,217,839,1056,-11640
"817","21147",664,5012,18,59,77,-4348
"818","21149",988,3381,15,137,152,-2393
"819","21151",11793,23431,353,1189,1542,-11638
"820","21153",1172,3824,17,66,83,-2652
"821","21155",2679,5122,33,215,248,-2443
"822","21157",3672,12322,84,426,510,-8650
"823","21159",363,3503,13,52,65,-3140
"824","21161",1970,4944,38,173,211,-2974
"825","21163",3026,8660,97,333,430,-5634
"826","21165",700,2010,14,43,57,-1310
"827","21167",2395,7740,68,275,343,-5345
"828","21169",976,3491,22,86,108,-2515
"829","21171",601,4278,13,76,89,-3677
"830","21173",3158,7856,68,264,332,-4698
"831","21175",1006,3628,26,63,89,-2622
"832","21177",3272,9393,44,230,274,-6121
"833","21179",6434,13430,131,565,696,-6996
"834","21181",787,1957,9,65,74,-1170
"835","21183",2080,7942,64,207,271,-5862
"836","21185",10268,20469,282,1229,1511,-10201
"837","21187",1062,3745,25,122,147,-2683
"838","21189",256,1474,0,24,24,-1218
"839","21191",1164,4604,27,145,172,-3440
"840","21193",2136,8158,47,168,215,-6022
"841","21195",4277,19740,86,411,497,-15463
"842","21197",1272,3513,27,118,145,-2241
"843","21199",4208,22900,127,562,689,-18692
"844","21201",222,759,5,19,24,-537
"845","21203",915,5609,25,87,112,-4694
"846","21205",3295,5174,85,207,292,-1879
"847","21207",1093,6863,14,153,167,-5770
"848","21209",7713,15052,139,853,992,-7339
"849","21211",6276,13196,138,629,767,-6920
"850","21213",2144,5077,38,200,238,-2933
"851","21215",1921,7196,44,237,281,-5275
"852","21217",2553,8320,53,233,286,-5767
"853","21219",1042,3612,26,64,90,-2570
"854","21221",1587,4928,45,121,166,-3341
"855","21223",879,2771,20,88,108,-1892
"856","21225",1331,4701,29,115,144,-3370
"857","21227",16966,28673,415,1605,2020,-11707
"858","21229",1420,4013,17,111,128,-2593
"859","21231",1431,6370,30,116,146,-4939
"860","21233",1240,4397,22,111,133,-3157
"861","21235",2067,11312,41,242,283,-9245
"862","21237",753,1804,9,42,51,-1051
"863","21239",4958,7697,117,529,646,-2739
"864","22001",5638,21159,106,281,387,-15521
"865","22003",2106,6867,50,102,152,-4761
"866","22005",16471,36135,324,1182,1506,-19664
"867","22007",3931,6714,39,127,166,-2783
"868","22009",5032,11163,69,188,257,-6131
"869","22011",2393,12238,64,225,289,-9845
"870","22013",3129,3756,23,54,77,-627
"871","22015",12638,35451,262,1022,1284,-22813
"872","22017",53448,48977,663,1861,2524,4471
"873","22019",26293,54182,551,1786,2337,-27889
"874","22021",788,3822,14,28,42,-3034
"875","22023",323,3256,16,57,73,-2933
"876","22025",1322,3479,14,17,31,-2157
"877","22027",2717,3585,25,45,70,-868
"878","22029",3272,5474,14,68,82,-2202
"879","22031",5163,8067,33,128,161,-2904
"880","22033",102711,84620,1642,4959,6601,18091
"881","22035",1838,1059,6,16,22,779
"882","22037",4235,5569,38,102,140,-1334
"883","22039",4208,10357,66,116,182,-6149
"884","22041",2506,6514,28,68,96,-4008
"885","22043",1181,7406,34,126,160,-6225
"886","22045",10698,20903,170,443,613,-10205
"887","22047",8324,7320,92,165,257,1004
"888","22049",2139,5169,20,74,94,-3030
"889","22051",73540,100292,1606,4297,5903,-26752
"890","22053",3080,10775,71,185,256,-7695
"891","22055",32726,68191,851,2833,3684,-35465
"892","22057",8423,31958,233,734,967,-23535
"893","22059",605,5835,19,53,72,-5230
"894","22061",7102,10761,120,440,560,-3659
"895","22063",6950,48797,292,1149,1441,-41847
"896","22065",2744,1927,15,17,32,817
"897","22067",5155,6502,46,73,119,-1347
"898","22069",7143,8965,91,260,351,-1822
"899","22071",133833,24267,2544,3636,6180,109566
"900","22073",24420,41712,343,980,1323,-17292
"901","22075",3347,6900,74,178,252,-3553
"902","22077",4764,6789,35,86,121,-2025
"903","22079",18318,36814,314,858,1172,-18496
"904","22081",1938,2391,11,47,58,-453
"905","22083",3157,6286,35,67,102,-3129
"906","22085",1703,7877,24,97,121,-6174
"907","22087",4957,10232,169,308,477,-5275
"908","22089",8558,16620,186,592,778,-8062
"909","22091",3353,2497,18,43,61,856
"910","22093",6418,5456,44,98,142,962
"911","22095",12658,7569,122,228,350,5089
"912","22097",17208,21966,181,349,530,-4758
"913","22099",8266,16872,121,303,424,-8606
"914","22101",8050,14353,85,245,330,-6303
"915","22103",27716,90914,1018,3409,4427,-63198
"916","22105",16869,33933,286,843,1129,-17064
"917","22107",1329,1180,8,13,21,149
"918","22109",10664,31900,215,808,1023,-21236
"919","22111",2691,7972,32,108,140,-5281
"920","22113",4745,19807,115,387,502,-15062
"921","22115",2665,13471,72,265,337,-10806
"922","22117",5690,12552,68,185,253,-6862
"923","22119",6259,11538,63,166,229,-5279
"924","22121",5382,6926,72,206,278,-1544
"925","22123",715,3970,10,27,37,-3255
"926","22125",2247,3390,17,97,114,-1143
"927","22127",1643,4605,29,40,69,-2962
"928","23001",22975,28189,885,3291,4176,-5214
"929","23003",13377,19419,516,1651,2167,-6042
"930","23005",102935,57697,3211,7406,10617,45238
"931","23007",7001,7900,379,1102,1481,-899
"932","23009",16107,13682,641,1553,2194,2425
"933","23011",29296,31753,1258,3692,4950,-2457
"934","23013",12440,9148,535,898,1433,3292
"935","23015",10241,9727,425,1039,1464,514
"936","23017",12172,16214,661,2047,2708,-4042
"937","23019",32832,41601,1417,4378,5795,-8769
"938","23021",3098,5403,179,464,643,-2305
"939","23023",10679,9304,435,1178,1613,1375
"940","23025",9092,14998,516,1362,1878,-5906
"941","23027",10442,10378,590,1220,1810,64
"942","23029",6358,9037,373,791,1164,-2679
"943","23031",55828,50388,2054,5692,7746,5440
"944","24001",6665,20025,336,778,1114,-13360
"945","24003",116074,114509,2991,9365,12356,1565
"946","24005",189437,131009,4573,9998,14571,58428
"947","24009",16669,24680,449,1647,2096,-8011
"948","24011",3747,8999,121,415,536,-5252
"949","24013",24314,55593,961,4011,4972,-31279
"950","24015",12651,27579,535,1544,2079,-14928
"951","24017",46063,24163,699,1555,2254,21900
"952","24019",5695,7938,94,307,401,-2243
"953","24021",51891,56472,1594,5005,6599,-4581
"954","24023",2252,10189,97,367,464,-7937
"955","24025",43803,74261,1474,4686,6160,-30458
"956","24027",93808,44792,2085,5716,7801,49016
"957","24029",4178,4598,102,288,390,-420
"958","24031",309761,82985,5637,9917,15554,226776
"959","24033",313627,29290,4211,3963,8174,284337
"960","24035",7316,16211,251,855,1106,-8895
"961","24037",15786,26889,452,2042,2494,-11103
"962","24039",3484,5056,57,171,228,-1572
"963","24041",7865,10098,182,586,768,-2233
"964","24043",19193,38842,704,1992,2696,-19649
"965","24045",16327,20832,388,1175,1563,-4505
"966","24047",8783,15910,227,651,878,-7127
"967","24510",178562,22726,3619,4073,7692,155836
"968","25001",71632,53842,1889,5304,7193,17790
"969","25003",43540,16799,1619,2549,4168,26741
"970","25005",127619,104775,3605,10069,13674,22844
"971","25007",8338,2474,258,364,622,5864
"972","25009",220027,135405,4615,16093,20708,84622
"973","25011",24369,10327,1405,1886,3291,14042
"974","25013",110313,78230,3415,8262,11677,32083
"975","25015",54572,22089,2590,3078,5668,32483
"976","25017",508919,216163,10271,31984,42255,292756
"977","25019",4144,1892,108,260,368,2252
"978","25021",219129,119171,3984,15497,19481,99958
"979","25023",133828,114722,3159,12459,15618,19106
"980","25025",241212,50042,4372,7891,12263,191170
"981","25027",197126,157138,5620,21088,26708,39988
"982","26001",1732,4201,54,164,218,-2469
"983","26003",1663,2585,67,177,244,-922
"984","26005",17932,33812,595,2498,3093,-15880
"985","26007",4877,9090,160,498,658,-4213
"986","26009",4448,8469,146,459,605,-4021
"987","26011",2238,4704,54,434,488,-2466
"988","26013",1156,2158,49,106,155,-1002
"989","26015",9109,19197,346,1424,1770,-10088
"990","26017",21641,28327,544,2189,2733,-6686
"991","26019",4108,5539,149,382,531,-1431
"992","26021",29496,38646,662,2760,3422,-9150
"993","26023",4740,11025,140,525,665,-6285
"994","26025",24154,31489,631,2282,2913,-7335
"995","26027",7270,14241,199,1453,1652,-6971
"996","26029",5137,8674,178,532,710,-3537
"997","26031",4302,8680,140,463,603,-4378
"998","26033",5378,9120,243,583,826,-3742
"999","26035",4250,8507,120,435,555,-4257
"1000","26037",16490,21635,379,1885,2264,-5145
"1001","26039",2110,4354,66,267,333,-2244
"1002","26041",6431,11112,182,660,842,-4681
"1003","26043",3923,8580,123,450,573,-4657
"1004","26045",24534,27608,602,2617,3219,-3074
"1005","26047",6972,10616,279,806,1085,-3644
"1006","26049",102744,84174,2193,6221,8414,18570
"1007","26051",3794,8124,87,393,480,-4330
"1008","26053",2925,4019,118,213,331,-1094
"1009","26055",20964,27412,756,2149,2905,-6448
"1010","26057",5665,9878,140,687,827,-4213
"1011","26059",4799,14094,184,700,884,-9295
"1012","26061",6018,8475,216,837,1053,-2457
"1013","26063",4579,10629,104,477,581,-6050
"1014","26065",81266,44354,1876,5369,7245,36912
"1015","26067",8206,16374,286,1338,1624,-8168
"1016","26069",4344,8344,146,459,605,-4000
"1017","26071",2004,3675,36,175,211,-1671
"1018","26073",11404,12338,396,1093,1489,-934
"1019","26075",25795,39793,713,2901,3614,-13998
"1020","26077",67142,51031,1634,5643,7277,16111
"1021","26079",2279,6213,118,283,401,-3934
"1022","26081",138567,147959,3995,14235,18230,-9392
"1023","26083",527,814,20,62,82,-287
"1024","26085",1939,3159,48,152,200,-1220
"1025","26087",12734,30037,426,1730,2156,-17303
"1026","26089",6774,7239,197,510,707,-465
"1027","26091",16750,26428,449,2044,2493,-9678
"1028","26093",34378,65665,911,4261,5172,-31287
"1029","26095",681,1756,29,103,132,-1075
"1030","26097",2085,3740,68,180,248,-1655
"1031","26099",176238,224589,3886,12860,16746,-48351
"1032","26101",4979,6915,200,456,656,-1936
"1033","26103",16042,14646,583,1458,2041,1396
"1034","26105",5281,8505,189,601,790,-3224
"1035","26107",5827,10305,229,697,926,-4478
"1036","26109",3539,6704,118,351,469,-3165
"1037","26111",15655,23877,408,2224,2632,-8222
"1038","26113",1565,5386,74,241,315,-3821
"1039","26115",26859,43255,707,2985,3692,-16396
"1040","26117",7874,16907,292,1316,1608,-9033
"1041","26119",1286,3498,44,159,203,-2212
"1042","26121",36640,35962,962,3170,4132,678
"1043","26123",6212,15174,197,878,1075,-8962
"1044","26125",342976,289127,6397,23143,29540,53849
"1045","26127",3973,7228,116,492,608,-3255
"1046","26129",3030,6827,118,353,471,-3797
"1047","26131",1175,2069,29,128,157,-894
"1048","26133",2705,7336,96,401,497,-4631
"1049","26135",1044,2843,18,140,158,-1799
"1050","26137",3556,8266,163,482,645,-4710
"1051","26139",46276,90456,1462,6476,7938,-44180
"1052","26141",2400,4486,50,237,287,-2086
"1053","26143",4287,8141,142,413,555,-3854
"1054","26145",44395,45469,780,3199,3979,-1074
"1055","26147",24553,49067,276,2972,3248,-24514
"1056","26149",7529,14886,290,935,1225,-7357
"1057","26151",4873,13446,170,662,832,-8573
"1058","26153",1369,2556,31,165,196,-1187
"1059","26155",12547,19232,362,1660,2022,-6685
"1060","26157",7493,17421,216,887,1103,-9928
"1061","26159",13258,17890,417,1480,1897,-4632
"1062","26161",128025,50335,2468,5806,8274,77690
"1063","26163",517022,228313,7750,18751,26501,288709
"1064","26165",4436,10000,192,579,771,-5564
"1065","27001",3134,5516,67,263,330,-2382
"1066","27003",75499,93341,2123,7726,9849,-17842
"1067","27005",5208,10880,130,580,710,-5672
"1068","27007",8688,10783,420,780,1200,-2095
"1069","27009",5640,12872,245,683,928,-7232
"1070","27011",921,1607,20,94,114,-686
"1071","27013",14428,15667,587,1604,2191,-1239
"1072","27015",3763,8708,136,503,639,-4945
"1073","27017",8460,8160,233,703,936,300
"1074","27019",21508,29057,488,2461,2949,-7549
"1075","27021",4949,9982,212,414,626,-5033
"1076","27023",1978,3764,70,209,279,-1786
"1077","27025",9279,18441,317,1213,1530,-9162
"1078","27027",12974,13549,416,1486,1902,-575
"1079","27029",1100,2925,33,94,127,-1825
"1080","27031",1912,1156,77,105,182,756
"1081","27033",1678,3679,41,150,191,-2001
"1082","27035",10982,22287,311,1174,1485,-11305
"1083","27037",110251,99624,2664,9867,12531,10627
"1084","27039",3102,6527,98,454,552,-3425
"1085","27041",6227,13966,167,781,948,-7739
"1086","27043",2153,4659,63,271,334,-2506
"1087","27045",3872,6271,103,409,512,-2399
"1088","27047",6041,8808,169,511,680,-2767
"1089","27049",9446,14041,262,1130,1392,-4595
"1090","27051",1104,2063,27,159,186,-959
"1091","27053",429283,191768,10310,24400,34710,237515
"1092","27055",4145,5616,135,394,529,-1471
"1093","27057",3432,7269,132,342,474,-3837
"1094","27059",5656,13635,219,765,984,-7979
"1095","27061",9015,12920,274,792,1066,-3905
"1096","27063",1492,3609,49,181,230,-2117
"1097","27065",2327,5230,81,298,379,-2903
"1098","27067",7266,12785,164,927,1091,-5519
"1099","27069",823,1349,15,121,136,-526
"1100","27071",2306,3569,69,207,276,-1263
"1101","27073",1301,2294,32,106,138,-993
"1102","27075",3077,2932,93,215,308,145
"1103","27077",553,1540,16,67,83,-987
"1104","27079",4623,9182,146,514,660,-4559
"1105","27081",860,1930,18,112,130,-1070
"1106","27083",3825,7256,115,523,638,-3431
"1107","27085",4978,12155,135,857,992,-7177
"1108","27087",930,991,34,54,88,-61
"1109","27089",1225,3208,30,204,234,-1983
"1110","27091",2733,7062,79,343,422,-4329
"1111","27093",3192,8103,94,449,543,-4911
"1112","27095",3709,8340,128,451,579,-4631
"1113","27097",3637,12925,146,442,588,-9288
"1114","27099",7444,8826,192,620,812,-1382
"1115","27101",1295,2974,22,203,225,-1679
"1116","27103",7886,8436,250,831,1081,-550
"1117","27105",2733,5299,40,258,298,-2566
"1118","27107",1264,1699,29,161,190,-435
"1119","27109",36266,35668,1116,3547,4663,598
"1120","27111",9339,20939,245,1000,1245,-11600
"1121","27113",2146,4000,46,315,361,-1854
"1122","27115",4580,8191,147,473,620,-3611
"1123","27117",1127,3338,44,131,175,-2211
"1124","27119",4712,8979,124,517,641,-4267
"1125","27121",2106,3793,43,221,264,-1687
"1126","27123",176929,70778,4546,9608,14154,106151
"1127","27125",540,1141,23,100,123,-601
"1128","27127",1887,5137,77,242,319,-3250
"1129","27129",2117,4890,66,244,310,-2773
"1130","27131",14437,15429,386,1230,1616,-992
"1131","27133",1373,3091,40,155,195,-1718
"1132","27135",1856,5451,42,220,262,-3595
"1133","27137",57769,44631,1878,4366,6244,13138
"1134","27139",28502,39948,741,3400,4141,-11446
"1135","27141",13299,31049,458,1927,2385,-17750
"1136","27143",1954,5193,64,291,355,-3239
"1137","27145",25575,47618,954,2972,3926,-22043
"1138","27147",6239,11198,208,808,1016,-4959
"1139","27149",2116,2800,69,205,274,-684
"1140","27151",1679,2962,32,153,185,-1283
"1141","27153",2783,8485,96,287,383,-5702
"1142","27155",631,1050,16,41,57,-419
"1143","27157",3866,6989,127,467,594,-3123
"1144","27159",1684,4837,58,164,222,-3153
"1145","27161",2838,5967,106,387,493,-3129
"1146","27163",67086,64429,1478,6180,7658,2657
"1147","27165",1814,2768,52,156,208,-954
"1148","27167",893,2129,34,146,180,-1236
"1149","27169",11366,12122,531,1165,1696,-756
"1150","27171",20336,43274,547,3002,3549,-22938
"1151","27173",1524,3382,37,163,200,-1858
"1152","28001",6921,5125,25,102,127,1796
"1153","28003",2684,11817,38,167,205,-9133
"1154","28005",2688,4282,7,38,45,-1594
"1155","28007",2847,4288,14,50,64,-1441
"1156","28009",1713,2240,9,28,37,-527
"1157","28011",8410,4251,30,92,122,4159
"1158","28013",1884,4360,10,49,59,-2476
"1159","28015",1648,3774,9,28,37,-2126
"1160","28017",3649,4127,12,61,73,-478
"1161","28019",1198,2763,12,26,38,-1565
"1162","28021",2523,414,3,5,8,2109
"1163","28023",2556,5088,15,29,44,-2532
"1164","28025",5695,4136,20,68,88,1559
"1165","28027",6378,2426,13,53,66,3952
"1166","28029",6203,5576,15,65,80,627
"1167","28031",3267,5423,12,61,73,-2156
"1168","28033",19892,42155,299,1305,1604,-22263
"1169","28035",11271,15149,142,584,726,-3878
"1170","28037",1471,2685,14,21,35,-1214
"1171","28039",1013,8652,20,89,109,-7639
"1172","28041",956,4309,4,28,32,-3353
"1173","28043",4386,5940,20,68,88,-1554
"1174","28045",3320,13720,81,309,390,-10400
"1175","28047",20679,39710,322,1183,1505,-19031
"1176","28049",64922,24919,441,937,1378,40003
"1177","28051",5820,1151,18,22,40,4669
"1178","28053",2652,924,2,10,12,1728
"1179","28055",395,298,0,4,4,97
"1180","28057",1100,8385,19,84,103,-7285
"1181","28059",13087,31204,152,820,972,-18117
"1182","28061",4367,4032,6,28,34,335
"1183","28063",3337,489,7,13,20,2848
"1184","28065",3720,2466,3,21,24,1254
"1185","28067",7748,20076,52,267,319,-12328
"1186","28069",2827,1778,1,18,19,1049
"1187","28071",7968,10872,134,577,711,-2904
"1188","28073",5044,18493,74,446,520,-13449
"1189","28075",10910,17574,70,296,366,-6664
"1190","28077",2181,4072,15,39,54,-1891
"1191","28079",3579,4775,13,39,52,-1196
"1192","28081",9635,21695,120,390,510,-12060
"1193","28083",6677,2757,25,73,98,3920
"1194","28085",4458,10550,26,89,115,-6092
"1195","28087",11545,13124,94,281,375,-1579
"1196","28089",18358,25607,127,748,875,-7249
"1197","28091",3572,7697,30,105,135,-4125
"1198","28093",7944,6525,55,95,150,1419
"1199","28095",5485,10107,28,106,134,-4622
"1200","28097",1775,2334,7,25,32,-559
"1201","28099",2668,7613,18,83,101,-4945
"1202","28101",2549,5929,18,59,77,-3380
"1203","28103",4330,1181,6,12,18,3149
"1204","28105",7851,7671,94,420,514,180
"1205","28107",7300,7371,20,95,115,-71
"1206","28109",2919,15530,75,275,350,-12611
"1207","28111",1220,4135,5,47,52,-2915
"1208","28113",7636,7748,40,138,178,-112
"1209","28115",2123,9442,33,138,171,-7319
"1210","28117",2067,7647,25,79,104,-5580
"1211","28119",2303,998,7,20,27,1305
"1212","28121",13741,46168,212,946,1158,-32427
"1213","28123",3999,5742,19,75,94,-1743
"1214","28125",1290,619,2,8,10,671
"1215","28127",3871,7393,22,74,96,-3522
"1216","28129",1598,5877,7,51,58,-4279
"1217","28131",1400,4810,14,104,118,-3410
"1218","28133",6560,2768,20,27,47,3792
"1219","28135",3337,2462,8,31,39,875
"1220","28137",3804,7385,20,110,130,-3581
"1221","28139",1808,7182,22,72,94,-5374
"1222","28141",990,7117,27,138,165,-6127
"1223","28143",2577,840,8,18,26,1737
"1224","28145",1969,9161,20,129,149,-7192
"1225","28147",2475,3374,9,24,33,-899
"1226","28149",8518,9420,53,217,270,-902
"1227","28151",9847,4541,31,99,130,5306
"1228","28153",3493,5957,3,45,48,-2464
"1229","28155",1001,3949,15,27,42,-2948
"1230","28157",2826,1305,4,15,19,1521
"1231","28159",3778,4874,29,54,83,-1096
"1232","28161",2574,3366,23,70,93,-792
"1233","28163",5221,4568,6,47,53,653
"1234","29001",3495,6019,147,426,573,-2524
"1235","29003",2045,6665,64,336,400,-4620
"1236","29005",541,2059,14,104,118,-1518
"1237","29007",2567,6981,73,363,436,-4414
"1238","29009",2710,11427,66,338,404,-8717
"1239","29011",795,4958,22,135,157,-4163
"1240","29013",1617,6000,55,306,361,-4383
"1241","29015",2024,7212,41,278,319,-5188
"1242","29017",705,4827,12,97,109,-4122
"1243","29019",41072,36146,1279,4262,5541,4926
"1244","29021",12010,21315,343,1709,2052,-9305
"1245","29023",3036,13647,98,392,490,-10611
"1246","29025",837,3231,26,188,214,-2394
"1247","29027",4988,13052,182,752,934,-8064
"1248","29029",4706,16721,110,588,698,-12015
"1249","29031",8468,26939,238,1106,1344,-18471
"1250","29033",745,3480,17,106,123,-2735
"1251","29035",436,2323,18,54,72,-1887
"1252","29037",14816,33006,420,2152,2572,-18190
"1253","29039",1010,5019,30,179,209,-4009
"1254","29041",888,2948,10,97,107,-2060
"1255","29043",8505,30941,245,1494,1739,-22436
"1256","29045",724,2458,22,101,123,-1734
"1257","29047",45182,57328,1093,5132,6225,-12146
"1258","29049",2572,7058,77,432,509,-4486
"1259","29051",10907,24610,253,1376,1629,-13703
"1260","29053",1932,5623,58,306,364,-3691
"1261","29055",1824,7724,91,224,315,-5900
"1262","29057",637,3184,16,94,110,-2547
"1263","29059",1271,5895,48,180,228,-4624
"1264","29061",730,2763,18,143,161,-2033
"1265","29063",824,3540,30,178,208,-2716
"1266","29065",978,5599,36,136,172,-4621
"1267","29067",984,5486,21,135,156,-4502
"1268","29069",2360,8026,30,142,172,-5666
"1269","29071",12339,35420,428,1627,2055,-23081
"1270","29073",1519,5670,47,180,227,-4151
"1271","29075",605,2304,9,108,117,-1699
"1272","29077",42400,77387,1452,5706,7158,-34987
"1273","29079",780,3462,28,118,146,-2682
"1274","29081",574,2965,19,97,116,-2391
"1275","29083",2356,7072,61,311,372,-4716
"1276","29085",1016,3539,31,108,139,-2523
"1277","29087",346,1926,6,66,72,-1580
"1278","29089",1279,3277,41,209,250,-1998
"1279","29091",2880,13888,131,434,565,-11008
"1280","29093",933,3173,30,110,140,-2240
"1281","29095",163723,114777,3457,10689,14146,48946
"1282","29097",10565,35058,484,1759,2243,-24493
"1283","29099",31546,68973,930,3966,4896,-37427
"1284","29101",5924,13702,205,1094,1299,-7778
"1285","29103",379,1413,12,53,65,-1034
"1286","29105",2543,12834,87,426,513,-10291
"1287","29107",4047,10977,92,597,689,-6930
"1288","29109",2898,13084,104,471,575,-10186
"1289","29111",933,3343,26,127,153,-2410
"1290","29113",5561,18111,197,808,1005,-12550
"1291","29115",1239,4084,54,172,226,-2845
"1292","29117",1265,4879,20,213,233,-3614
"1293","29119",1329,6599,70,191,261,-5270
"1294","29121",1518,5794,57,175,232,-4276
"1295","29123",1005,4102,30,150,180,-3097
"1296","29125",794,3559,23,110,133,-2765
"1297","29127",2993,9418,63,379,442,-6425
"1298","29129",216,1486,2,27,29,-1270
"1299","29131",1750,9285,58,283,341,-7535
"1300","29133",1458,3600,15,79,94,-2142
"1301","29135",1237,5344,26,175,201,-4107
"1302","29137",853,3159,13,114,127,-2306
"1303","29139",1118,4124,32,133,165,-3006
"1304","29141",1768,6757,51,202,253,-4989
"1305","29143",1933,5270,24,106,130,-3337
"1306","29145",4988,20546,168,641,809,-15558
"1307","29147",2529,6379,61,401,462,-3850
"1308","29149",865,3668,14,88,102,-2803
"1309","29151",998,5845,34,182,216,-4847
"1310","29153",724,3639,41,70,111,-2915
"1311","29155",1946,3964,21,78,99,-2018
"1312","29157",1520,6907,39,231,270,-5387
"1313","29159",4322,12792,112,733,845,-8470
"1314","29161",4761,12699,198,746,944,-7938
"1315","29163",1806,5274,50,208,258,-3468
"1316","29165",18915,24975,394,2154,2548,-6060
"1317","29167",2630,10435,77,479,556,-7805
"1318","29169",2918,9870,106,477,583,-6952
"1319","29171",352,1936,13,36,49,-1584
"1320","29173",1138,3969,17,120,137,-2831
"1321","29175",2283,7529,60,392,452,-5246
"1322","29177",3088,7103,61,508,569,-4015
"1323","29179",540,2402,20,62,82,-1862
"1324","29181",830,4520,35,115,150,-3690
"1325","29183",68225,120899,1685,7913,9598,-52674
"1326","29185",936,3501,24,146,170,-2565
"1327","29186",2540,5495,55,323,378,-2955
"1328","29187",6250,17467,171,712,883,-11217
"1329","29189",280866,199081,5072,16310,21382,81785
"1330","29195",2787,5977,69,383,452,-3190
"1331","29197",354,1505,7,65,72,-1151
"1332","29199",365,1525,18,50,68,-1160
"1333","29201",3574,13168,79,373,452,-9594
"1334","29203",776,2966,28,106,134,-2190
"1335","29205",606,2524,16,92,108,-1918
"1336","29207",1873,11077,45,238,283,-9204
"1337","29209",2886,13149,59,382,441,-10263
"1338","29211",526,1884,9,58,67,-1358
"1339","29213",4367,18240,129,521,650,-13873
"1340","29215",1728,8875,52,222,274,-7147
"1341","29217",1706,6526,67,235,302,-4820
"1342","29219",3915,11109,116,534,650,-7194
"1343","29221",1926,7047,60,197,257,-5121
"1344","29223",946,4640,29,105,134,-3694
"1345","29225",3173,12829,85,514,599,-9656
"1346","29227",195,808,5,32,37,-613
"1347","29229",1166,6703,22,153,175,-5537
"1348","29510",101487,20281,1945,3405,5350,81206
"1349","30001",1115,3243,69,249,318,-2128
"1350","30003",2061,1833,70,184,254,228
"1351","30005",1187,1259,73,102,175,-72
"1352","30007",566,2329,37,165,202,-1763
"1353","30009",1824,3729,68,302,370,-1905
"1354","30011",70,677,6,24,30,-607
"1355","30013",12053,19343,440,1955,2395,-7290
"1356","30015",729,1676,36,130,166,-947
"1357","30017",1172,3638,35,300,335,-2466
"1358","30019",167,729,6,50,56,-562
"1359","30021",786,3298,33,180,213,-2512
"1360","30023",2018,1736,71,274,345,282
"1361","30025",154,1276,3,41,44,-1122
"1362","30027",1196,4235,51,300,351,-3039
"1363","30029",13233,30079,650,2182,2832,-16846
"1364","30031",23879,23360,1028,3902,4930,519
"1365","30033",34,653,1,27,28,-619
"1366","30035",3076,1598,93,202,295,1478
"1367","30037",71,365,3,29,32,-294
"1368","30039",469,1185,25,83,108,-716
"1369","30041",2350,3446,118,433,551,-1096
"1370","30043",1975,4099,75,386,461,-2124
"1371","30045",232,867,12,78,90,-635
"1372","30047",4703,7453,217,525,742,-2750
"1373","30049",14331,16665,538,2163,2701,-2334
"1374","30051",205,695,2,47,49,-490
"1375","30053",2040,6720,95,395,490,-4680
"1376","30055",154,858,7,37,44,-704
"1377","30057",1175,3280,58,195,253,-2105
"1378","30059",191,728,10,41,51,-537
"1379","30061",515,1322,35,102,137,-807
"1380","30063",30740,21699,1605,3227,4832,9041
"1381","30065",331,1961,18,94,112,-1630
"1382","30067",3521,4872,187,476,663,-1351
"1383","30069",30,276,1,12,13,-246
"1384","30071",315,1715,19,98,117,-1400
"1385","30073",737,1786,34,135,169,-1049
"1386","30075",127,880,1,39,40,-753
"1387","30077",549,2017,40,162,202,-1468
"1388","30079",100,555,1,30,31,-455
"1389","30081",6166,14673,255,969,1224,-8507
"1390","30083",669,3885,22,236,258,-3216
"1391","30085",1504,1722,90,170,260,-218
"1392","30087",969,2211,31,146,177,-1242
"1393","30089",1211,4268,94,298,392,-3057
"1394","30091",476,1237,20,92,112,-761
"1395","30093",8545,6252,289,1036,1325,2293
"1396","30095",904,3630,34,248,282,-2726
"1397","30097",398,1580,23,76,99,-1182
"1398","30099",803,2152,27,161,188,-1349
"1399","30101",399,1495,28,96,124,-1096
"1400","30103",59,350,6,26,32,-291
"1401","30105",886,2697,43,234,277,-1811
"1402","30107",179,698,14,41,55,-519
"1403","30109",55,460,0,18,18,-405
"1404","30111",21117,38675,822,4061,4883,-17558
"1405","31001",3272,9205,110,585,695,-5933
"1406","31003",381,2717,19,103,122,-2336
"1407","31005",16,237,0,10,10,-221
"1408","31007",18,355,3,14,17,-337
"1409","31009",30,273,0,10,10,-243
"1410","31011",414,2299,17,137,154,-1885
"1411","31013",953,3550,35,223,258,-2597
"1412","31015",128,978,13,23,36,-850
"1413","31017",153,1380,7,39,46,-1227
"1414","31019",4690,14424,219,1144,1363,-9734
"1415","31021",928,2360,39,196,235,-1432
"1416","31023",690,3068,27,129,156,-2378
"1417","31025",3461,8388,131,629,760,-4927
"1418","31027",572,3533,31,224,255,-2961
"1419","31029",171,1621,6,53,59,-1450
"1420","31031",317,2623,15,127,142,-2306
"1421","31033",702,3610,46,211,257,-2908
"1422","31035",470,2373,15,115,130,-1903
"1423","31037",857,2171,26,118,144,-1314
"1424","31039",712,3095,25,156,181,-2383
"1425","31041",635,4616,37,201,238,-3981
"1426","31043",2904,4028,59,268,327,-1124
"1427","31045",785,2559,48,186,234,-1774
"1428","31047",2116,5935,58,377,435,-3819
"1429","31049",120,809,1,47,48,-689
"1430","31051",556,2041,17,130,147,-1485
"1431","31053",4451,9736,155,617,772,-5285
"1432","31055",105207,102151,2600,9573,12173,3056
"1433","31057",89,823,6,31,37,-734
"1434","31059",610,2100,20,149,169,-1490
"1435","31061",250,1345,7,54,61,-1095
"1436","31063",161,1106,8,35,43,-945
"1437","31065",304,1915,11,85,96,-1611
"1438","31067",2930,6333,102,489,591,-3403
"1439","31069",153,869,2,39,41,-716
"1440","31071",121,819,5,23,28,-698
"1441","31073",165,792,6,37,43,-627
"1442","31075",20,367,1,6,7,-347
"1443","31077",210,911,6,38,44,-701
"1444","31079",6142,14139,184,866,1050,-7997
"1445","31081",873,3763,43,223,266,-2890
"1446","31083",219,1302,7,54,61,-1083
"1447","31085",30,471,1,8,9,-441
"1448","31087",158,1216,6,60,66,-1058
"1449","31089",522,4275,27,155,182,-3753
"1450","31091",40,355,3,16,19,-315
"1451","31093",544,2284,22,108,130,-1740
"1452","31095",831,2387,30,182,212,-1556
"1453","31097",560,1348,22,121,143,-788
"1454","31099",550,2519,26,147,173,-1969
"1455","31101",560,3203,24,158,182,-2643
"1456","31103",39,458,0,17,17,-419
"1457","31105",227,1317,18,74,92,-1090
"1458","31107",715,3181,29,136,165,-2466
"1459","31109",60533,60456,1899,6915,8814,77
"1460","31111",2878,11992,106,698,804,-9114
"1461","31113",32,400,1,18,19,-368
"1462","31115",48,323,1,10,11,-275
"1463","31117",14,257,1,14,15,-243
"1464","31119",2663,10518,121,654,775,-7855
"1465","31121",601,2914,27,165,192,-2313
"1466","31123",282,1788,14,82,96,-1506
"1467","31125",280,1257,15,47,62,-977
"1468","31127",765,2068,26,176,202,-1303
"1469","31129",348,1709,19,77,96,-1361
"1470","31131",2017,4833,57,372,429,-2816
"1471","31133",279,970,10,55,65,-691
"1472","31135",160,1202,4,52,56,-1042
"1473","31137",571,3832,18,188,206,-3261
"1474","31139",382,3052,21,125,146,-2670
"1475","31141",2612,10864,84,487,571,-8252
"1476","31143",411,2019,6,102,108,-1608
"1477","31145",638,4212,26,185,211,-3574
"1478","31147",798,2684,27,157,184,-1886
"1479","31149",70,687,4,32,36,-617
"1480","31151",1630,2849,49,267,316,-1219
"1481","31153",27704,44649,817,4611,5428,-16945
"1482","31155",2509,7486,95,508,603,-4977
"1483","31157",3151,9952,122,670,792,-6801
"1484","31159",1881,5451,82,340,422,-3570
"1485","31161",286,2192,18,69,87,-1906
"1486","31163",338,1143,13,59,72,-805
"1487","31165",77,602,4,26,30,-525
"1488","31167",417,2173,14,144,158,-1756
"1489","31169",490,1993,10,120,130,-1503
"1490","31171",30,344,3,10,13,-314
"1491","31173",911,1013,49,56,105,-102
"1492","31175",337,1770,12,53,65,-1433
"1493","31177",2606,7374,95,509,604,-4768
"1494","31179",828,2675,35,202,237,-1847
"1495","31181",306,1320,10,51,61,-1014
"1496","31183",62,377,4,16,20,-315
"1497","31185",1181,4686,52,337,389,-3505
"1498","32001",2210,7828,NA,450,NA,-5618
"1499","32003",401068,319571,NA,22407,NA,81497
"1500","32005",8453,17406,NA,1002,NA,-8953
"1501","32007",3400,13542,NA,824,NA,-10142
"1502","32009",65,329,NA,15,NA,-264
"1503","32011",74,723,NA,19,NA,-649
"1504","32013",1386,4521,NA,269,NA,-3135
"1505","32015",403,1828,NA,79,NA,-1425
"1506","32017",285,1671,NA,62,NA,-1386
"1507","32019",6146,16005,NA,813,NA,-9859
"1508","32021",637,1179,NA,88,NA,-542
"1509","32023",5095,13320,NA,552,NA,-8225
"1510","32027",430,1403,NA,58,NA,-973
"1511","32029",752,1616,NA,100,NA,-864
"1512","32031",97032,94529,NA,9251,NA,2503
"1513","32033",707,2723,NA,151,NA,-2016
"1514","32510",9610,13125,NA,1159,NA,-3515
"1515","33001",13517,19315,284,1346,1630,-5798
"1516","33003",12987,14635,256,1185,1441,-1648
"1517","33005",22064,16876,484,1656,2140,5188
"1518","33007",6558,7951,170,573,743,-1393
"1519","33009",28508,19010,578,1966,2544,9498
"1520","33011",99348,99873,1745,9243,10988,-525
"1521","33013",40056,37631,706,3275,3981,2425
"1522","33015",79994,90447,1219,7171,8390,-10453
"1523","33017",34884,29064,694,3258,3952,5820
"1524","33019",10210,10796,238,857,1095,-586
"1525","34001",54472,47882,933,1915,2848,6590
"1526","34003",209251,163220,3709,7037,10746,46031
"1527","34005",108361,79539,2138,4381,6519,28822
"1528","34007",142375,71020,1932,4142,6074,71355
"1529","34009",18626,28237,387,895,1282,-9611
"1530","34011",27045,24213,486,1029,1515,2832
"1531","34013",231031,62059,2830,3028,5858,168972
"1532","34015",66355,66949,1243,3193,4436,-594
"1533","34017",149980,45615,2436,2603,5039,104365
"1534","34019",28797,38565,805,2208,3013,-9768
"1535","34021",93721,42604,1519,2907,4426,51117
"1536","34023",164887,108981,3050,4686,7736,55906
"1537","34025",135825,165305,3138,6321,9459,-29480
"1538","34027",114437,125376,2516,5903,8419,-10939
"1539","34029",81845,170103,2012,4563,6575,-88258
"1540","34031",112608,71488,1896,2478,4374,41120
"1541","34033",11766,16256,236,855,1091,-4490
"1542","34035",83839,64640,1532,3694,5226,19199
"1543","34037",24132,46486,840,2018,2858,-22354
"1544","34039",145412,67582,1760,3598,5358,77830
"1545","34041",16991,29393,551,1241,1792,-12402
"1546","35001",141960,93874,3572,29393,32965,48086
"1547","35003",426,1453,23,109,132,-1027
"1548","35005",5530,12869,86,1606,1692,-7339
"1549","35006",3721,3179,73,961,1034,542
"1550","35007",2118,2569,37,524,561,-451
"1551","35009",2776,7560,65,842,907,-4784
"1552","35011",192,617,6,88,94,-425
"1553","35013",37543,25095,941,5413,6354,12448
"1554","35015",5008,13124,84,1262,1346,-8116
"1555","35017",6226,5251,218,888,1106,975
"1556","35019",962,591,18,237,255,371
"1557","35021",156,311,3,55,58,-155
"1558","35023",780,906,5,137,142,-126
"1559","35025",3877,12306,53,1081,1134,-8429
"1560","35027",2329,5889,59,559,618,-3560
"1561","35028",5443,3329,119,1498,1617,2114
"1562","35029",3195,3478,66,481,547,-283
"1563","35031",13162,4893,269,2319,2588,8269
"1564","35033",1533,662,35,193,228,871
"1565","35035",6033,11756,164,1584,1748,-5723
"1566","35037",1016,2208,15,299,314,-1192
"1567","35039",9534,3583,186,1418,1604,5951
"1568","35041",1445,3865,47,474,521,-2420
"1569","35043",27405,25748,618,6588,7206,1657
"1570","35045",12826,27879,351,4177,4528,-15053
"1571","35047",7249,2302,158,910,1068,4947
"1572","35049",49956,14198,1421,4313,5734,35758
"1573","35051",1600,2998,75,437,512,-1398
"1574","35053",3275,2592,58,794,852,683
"1575","35055",10550,2706,608,1170,1778,7844
"1576","35057",1770,3695,66,688,754,-1925
"1577","35059",318,1214,13,133,146,-896
"1578","35061",10810,13175,217,3038,3255,-2365
"1579","36001",74775,44227,2291,4351,6642,30548
"1580","36003",4473,11712,251,675,926,-7239
"1581","36005",318403,34424,3960,2070,6030,283979
"1582","36007",35212,38077,1405,2963,4368,-2865
"1583","36009",8717,18668,419,1157,1576,-9951
"1584","36011",12202,16194,473,1255,1728,-3992
"1585","36013",17281,29418,697,1985,2682,-12137
"1586","36015",12394,19025,429,1347,1776,-6631
"1587","36017",5943,11024,323,823,1146,-5081
"1588","36019",13446,13181,566,1185,1751,265
"1589","36021",13123,12756,537,839,1376,367
"1590","36023",7976,9207,353,888,1241,-1231
"1591","36025",5825,11012,344,597,941,-5187
"1592","36027",56874,58163,1858,3304,5162,-1289
"1593","36029",192065,173817,5824,11542,17366,18248
"1594","36031",6760,7275,380,664,1044,-515
"1595","36033",6517,7636,338,657,995,-1119
"1596","36035",5805,12759,288,711,999,-6954
"1597","36037",6946,15986,292,1239,1531,-9040
"1598","36039",6370,11546,385,568,953,-5176
"1599","36041",752,1795,39,102,141,-1043
"1600","36043",7289,15664,370,938,1308,-8375
"1601","36045",12289,19947,560,1467,2027,-7658
"1602","36047",595086,133653,11165,6391,17556,461433
"1603","36049",2828,6916,122,446,568,-4088
"1604","36051",10478,19211,429,1245,1674,-8733
"1605","36053",10548,14901,483,1460,1943,-4353
"1606","36055",174063,128871,4957,12273,17230,45192
"1607","36057",5961,10579,250,648,898,-4618
"1608","36059",307326,275479,6356,10488,16844,31847
"1609","36061",515481,58935,8515,8437,16952,456546
"1610","36063",32888,49223,1223,2666,3889,-16335
"1611","36065",30749,48490,1159,3478,4637,-17741
"1612","36067",102915,78277,2909,7861,10770,24638
"1613","36069",20233,24343,803,2285,3088,-4110
"1614","36071",63037,72129,2017,3570,5587,-9092
"1615","36073",4327,11582,179,634,813,-7255
"1616","36075",15614,25870,662,1976,2638,-10256
"1617","36077",9285,12284,478,977,1455,-2999
"1618","36079",17363,25241,543,1039,1582,-7878
"1619","36081",473389,138550,8512,6570,15082,334839
"1620","36083",30039,31933,1261,2758,4019,-1894
"1621","36085",67561,95612,1774,2262,4036,-28051
"1622","36087",63454,57148,1245,2096,3341,6306
"1623","36089",14659,18450,746,1299,2045,-3791
"1624","36091",46546,51088,1714,4741,6455,-4542
"1625","36093",30870,27268,1046,2445,3491,3602
"1626","36095",3777,8173,253,470,723,-4396
"1627","36097",2761,5179,200,283,483,-2418
"1628","36099",5175,6719,244,589,833,-1544
"1629","36101",11215,25091,545,1522,2067,-13876
"1630","36103",276953,328403,7603,12761,20364,-51450
"1631","36105",10983,14626,382,518,900,-3643
"1632","36107",6852,12528,320,856,1176,-5676
"1633","36109",25555,9647,1258,1287,2545,15908
"1634","36111",40010,32962,1986,2176,4162,7048
"1635","36113",11366,14284,789,1129,1918,-2918
"1636","36115",8238,12770,550,843,1393,-4532
"1637","36117",12378,21935,520,1765,2285,-9557
"1638","36119",245670,121643,4008,7185,11193,124027
"1639","36121",3585,11884,171,640,811,-8299
"1640","36123",3219,5180,136,440,576,-1961
"1641","37001",29268,38235,NA,1761,NA,-8967
"1642","37003",3750,13826,NA,435,NA,-10076
"1643","37005",1300,3789,NA,125,NA,-2489
"1644","37007",5785,4480,NA,129,NA,1305
"1645","37009",3476,9353,NA,331,NA,-5877
"1646","37011",1670,6226,NA,164,NA,-4556
"1647","37013",8699,14478,NA,422,NA,-5779
"1648","37015",5837,3476,NA,67,NA,2361
"1649","37017",7021,8511,NA,211,NA,-1490
"1650","37019",23117,42440,NA,1698,NA,-19323
"1651","37021",74937,55339,NA,4231,NA,19598
"1652","37023",10930,25741,NA,967,NA,-14811
"1653","37025",35048,53224,NA,2730,NA,-18176
"1654","37027",8403,26499,NA,845,NA,-18096
"1655","37029",1266,3527,NA,146,NA,-2261
"1656","37031",9806,26228,NA,885,NA,-16422
"1657","37033",4549,5758,NA,208,NA,-1209
"1658","37035",21050,48062,NA,1953,NA,-27012
"1659","37037",20953,17012,NA,1115,NA,3941
"1660","37039",2809,10711,NA,340,NA,-7902
"1661","37041",2965,3983,NA,160,NA,-1018
"1662","37043",1352,4395,NA,138,NA,-3043
"1663","37045",14896,28394,NA,847,NA,-13498
"1664","37047",8991,14177,NA,304,NA,-5186
"1665","37049",17481,27556,NA,1194,NA,-10075
"1666","37051",70523,50593,NA,3286,NA,19930
"1667","37053",2879,9070,NA,474,NA,-6191
"1668","37055",7079,11283,NA,647,NA,-4204
"1669","37057",17328,52870,NA,1815,NA,-35542
"1670","37059",5228,15502,NA,620,NA,-10274
"1671","37061",8196,12151,NA,254,NA,-3955
"1672","37063",118783,27879,NA,3881,NA,90904
"1673","37065",16152,8219,NA,282,NA,7933
"1674","37067",92488,74793,NA,5228,NA,17695
"1675","37069",12811,16320,NA,771,NA,-3509
"1676","37071",30982,61467,NA,2423,NA,-30485
"1677","37073",2371,2851,NA,106,NA,-480
"1678","37075",761,3260,NA,73,NA,-2499
"1679","37077",12827,13500,NA,593,NA,-673
"1680","37079",3570,4358,NA,85,NA,-788
"1681","37081",147949,97461,NA,6677,NA,50488
"1682","37083",15642,8954,NA,285,NA,6688
"1683","37085",16452,27278,NA,1225,NA,-10826
"1684","37087",10414,18844,NA,898,NA,-8430
"1685","37089",19664,35535,NA,1611,NA,-15871
"1686","37091",6886,3081,NA,133,NA,3805
"1687","37093",9608,7676,NA,563,NA,1932
"1688","37095",956,1275,NA,42,NA,-319
"1689","37097",24441,54164,NA,2122,NA,-29723
"1690","37099",7564,9706,NA,734,NA,-2142
"1691","37101",28153,54082,NA,2318,NA,-25929
"1692","37103",2041,2941,NA,57,NA,-900
"1693","37105",10380,13625,NA,671,NA,-3245
"1694","37107",11752,13354,NA,394,NA,-1602
"1695","37109",9836,28653,NA,960,NA,-18817
"1696","37111",4645,14517,NA,395,NA,-9872
"1697","37113",4841,12035,NA,460,NA,-7194
"1698","37115",3899,6735,NA,332,NA,-2836
"1699","37117",5814,5874,NA,164,NA,-60
"1700","37119",292258,154303,NA,15273,NA,137955
"1701","37121",1585,6225,NA,138,NA,-4640
"1702","37123",4108,7070,NA,271,NA,-2962
"1703","37125",16148,30273,NA,1325,NA,-14125
"1704","37127",23024,23142,NA,737,NA,-118
"1705","37129",50219,54665,NA,3853,NA,-4446
"1706","37131",6113,3556,NA,92,NA,2557
"1707","37133",17156,36342,NA,1866,NA,-19186
"1708","37135",59105,18373,NA,2352,NA,40732
"1709","37137",2427,4225,NA,120,NA,-1798
"1710","37139",8455,8082,NA,427,NA,373
"1711","37141",9086,17317,NA,669,NA,-8231
"1712","37143",2291,4143,NA,161,NA,-1852
"1713","37145",7772,11116,NA,415,NA,-3344
"1714","37147",40967,35191,NA,2106,NA,5776
"1715","37149",3715,6738,NA,270,NA,-3023
"1716","37151",13074,49156,NA,1385,NA,-36082
"1717","37153",8290,10199,NA,324,NA,-1909
"1718","37155",18377,20294,NA,783,NA,-1917
"1719","37157",14057,26463,NA,854,NA,-12406
"1720","37159",19208,42388,NA,1482,NA,-23180
"1721","37161",7451,21694,NA,619,NA,-14243
"1722","37163",10486,14761,NA,391,NA,-4275
"1723","37165",7279,6212,NA,252,NA,1067
"1724","37167",7008,21788,NA,655,NA,-14780
"1725","37169",4645,16976,NA,561,NA,-12331
"1726","37171",7438,23495,NA,730,NA,-16057
"1727","37173",2186,3557,NA,239,NA,-1371
"1728","37175",6520,10441,NA,479,NA,-3921
"1729","37177",705,968,NA,27,NA,-263
"1730","37179",34051,66265,NA,3280,NA,-32214
"1731","37181",12168,7304,NA,290,NA,4864
"1732","37183",298353,193607,NA,18980,NA,104746
"1733","37185",6668,3302,NA,153,NA,3366
"1734","37187",3490,2560,NA,65,NA,930
"1735","37189",13953,13521,NA,1295,NA,432
"1736","37191",21520,27360,NA,944,NA,-5840
"1737","37193",6596,23613,NA,635,NA,-17017
"1738","37195",19527,17410,NA,656,NA,2117
"1739","37197",3140,13815,NA,395,NA,-10675
"1740","37199",3181,6367,NA,260,NA,-3186
"1741","38001",216,904,8,65,73,-688
"1742","38003",1597,3156,47,406,453,-1559
"1743","38005",842,927,41,112,153,-85
"1744","38007",58,492,4,31,35,-434
"1745","38009",734,2482,30,177,207,-1748
"1746","38011",227,1445,13,78,91,-1218
"1747","38013",118,879,5,26,31,-761
"1748","38015",10865,32499,480,2719,3199,-21634
"1749","38017",31291,39738,1204,6077,7281,-8447
"1750","38019",476,1356,19,110,129,-880
"1751","38021",551,1656,22,122,144,-1105
"1752","38023",243,860,9,70,79,-617
"1753","38025",356,1753,14,60,74,-1397
"1754","38027",354,790,15,53,68,-436
"1755","38029",215,1672,10,52,62,-1457
"1756","38031",346,1237,10,96,106,-891
"1757","38033",99,793,4,40,44,-694
"1758","38035",10828,16325,382,2002,2384,-5497
"1759","38037",187,1098,7,63,70,-911
"1760","38039",298,847,6,93,99,-549
"1761","38041",168,1032,5,46,51,-864
"1762","38043",179,1106,7,63,70,-927
"1763","38045",500,1475,13,107,120,-975
"1764","38047",112,867,5,38,43,-755
"1765","38049",474,1991,18,182,200,-1517
"1766","38051",233,1095,10,71,81,-862
"1767","38053",696,3661,35,171,206,-2965
"1768","38055",1070,3827,29,249,278,-2757
"1769","38057",616,3715,20,188,208,-3099
"1770","38059",3077,11319,141,912,1053,-8242
"1771","38061",1211,2551,56,163,219,-1340
"1772","38063",536,1025,11,113,124,-489
"1773","38065",119,827,3,46,49,-708
"1774","38067",681,2204,27,167,194,-1523
"1775","38069",431,1433,9,132,141,-1002
"1776","38071",1505,3216,44,405,449,-1711
"1777","38073",836,1209,22,245,267,-373
"1778","38075",200,978,4,68,72,-778
"1779","38077",2064,4759,76,492,568,-2695
"1780","38079",2097,1210,175,155,330,887
"1781","38081",693,1088,18,166,184,-395
"1782","38083",94,644,1,29,30,-550
"1783","38085",758,256,128,25,153,502
"1784","38087",42,361,3,19,22,-319
"1785","38089",1745,9718,60,522,582,-7973
"1786","38091",361,537,6,73,79,-176
"1787","38093",2484,6706,109,571,680,-4222
"1788","38095",305,733,7,89,96,-428
"1789","38097",1239,2263,35,289,324,-1024
"1790","38099",1166,2991,32,330,362,-1825
"1791","38101",5792,18601,242,2050,2292,-12809
"1792","38103",419,1793,14,101,115,-1374
"1793","38105",1722,10033,74,622,696,-8311
"1794","39001",2293,8445,43,220,263,-6152
"1795","39003",12815,29858,310,1440,1750,-17043
"1796","39005",5659,17169,180,888,1068,-11510
"1797","39007",15191,22755,417,1181,1598,-7564
"1798","39009",15552,10816,507,944,1451,4736
"1799","39011",3825,18130,105,673,778,-14305
"1800","39013",8652,20729,186,760,946,-12077
"1801","39015",4270,14257,102,419,521,-9987
"1802","39017",56700,104441,1119,5612,6731,-47741
"1803","39019",3124,9067,87,444,531,-5943
"1804","39021",4488,12314,140,555,695,-7826
"1805","39023",22666,34311,492,1831,2323,-11645
"1806","39025",26096,65960,702,3385,4087,-39864
"1807","39027",3943,13466,125,488,613,-9523
"1808","39029",12273,31086,313,1368,1681,-18813
"1809","39031",3908,10381,112,447,559,-6473
"1810","39033",4518,13265,114,687,801,-8747
"1811","39035",383974,179894,5026,12526,17552,204080
"1812","39037",4395,19698,146,639,785,-15303
"1813","39039",5282,11478,144,766,910,-6196
"1814","39041",39584,55660,618,3919,4537,-16076
"1815","39043",15692,19301,329,1185,1514,-3609
"1816","39045",24150,43163,529,2341,2870,-19013
"1817","39047",2672,7763,53,283,336,-5091
"1818","39049",335961,192328,5789,18851,24640,143633
"1819","39051",5981,13419,162,993,1155,-7438
"1820","39053",2564,9567,94,282,376,-7003
"1821","39055",17165,29577,318,1452,1770,-12412
"1822","39057",28023,47506,646,3169,3815,-19483
"1823","39059",4286,11164,93,529,622,-6878
"1824","39061",207587,169972,3521,12750,16271,37615
"1825","39063",9419,23777,312,1493,1805,-14358
"1826","39065",2870,8541,76,450,526,-5671
"1827","39067",1663,5021,51,171,222,-3358
"1828","39069",3690,9136,108,638,746,-5446
"1829","39071",3436,13005,95,428,523,-9569
"1830","39073",3713,8282,87,352,439,-4569
"1831","39075",1766,8578,48,369,417,-6812
"1832","39077",7080,15930,186,897,1083,-8850
"1833","39079",3142,9618,60,352,412,-6476
"1834","39081",9483,20668,190,815,1005,-11185
"1835","39083",7959,18563,204,881,1085,-10604
"1836","39085",45056,62627,905,3702,4607,-17571
"1837","39087",6849,18240,156,564,720,-11391
"1838","39089",26360,49346,682,2575,3257,-22986
"1839","39091",4537,15586,122,640,762,-11049
"1840","39093",64958,65346,1224,4414,5638,-388
"1841","39095",107363,74102,2172,7214,9386,33261
"1842","39097",4662,11319,106,583,689,-6657
"1843","39099",56188,52808,856,2559,3415,3380
"1844","39101",7748,16563,226,956,1182,-8815
"1845","39103",31582,53811,693,2893,3586,-22229
"1846","39105",2157,6869,59,263,322,-4712
"1847","39107",3335,17200,108,552,660,-13865
"1848","39109",12832,36311,305,1792,2097,-23479
"1849","39111",1647,4781,36,161,197,-3134
"1850","39113",117661,120766,2183,8085,10268,-3105
"1851","39115",1711,4315,42,186,228,-2604
"1852","39117",3711,11722,98,555,653,-8011
"1853","39119",10926,23588,251,1215,1466,-12662
"1854","39121",1201,4441,34,148,182,-3240
"1855","39123",8136,12389,143,935,1078,-4253
"1856","39125",2068,6359,71,269,340,-4291
"1857","39127",4072,9978,99,394,493,-5906
"1858","39129",6325,16482,165,732,897,-10157
"1859","39131",3443,7669,54,269,323,-4226
"1860","39133",31463,38978,800,2325,3125,-7515
"1861","39135",4323,15376,126,548,674,-11053
"1862","39137",2874,14704,69,626,695,-11830
"1863","39139",15629,35805,373,1586,1959,-20176
"1864","39141",9905,17833,198,869,1067,-7928
"1865","39143",9733,16045,302,1229,1531,-6312
"1866","39145",8841,19742,201,671,872,-10901
"1867","39147",7237,14559,236,1270,1506,-7322
"1868","39149",4143,18148,120,572,692,-14005
"1869","39151",66581,96345,1355,5541,6896,-29764
"1870","39153",129922,109531,2244,7226,9470,20391
"1871","39155",42130,48152,830,2434,3264,-6022
"1872","39157",11895,26105,275,1560,1835,-14210
"1873","39159",7530,17601,196,1088,1284,-10071
"1874","39161",2667,10328,102,419,521,-7661
"1875","39163",1332,3799,43,164,207,-2467
"1876","39165",33036,75947,697,4237,4934,-42911
"1877","39167",7841,19901,201,872,1073,-12060
"1878","39169",14670,31622,364,1586,1950,-16952
"1879","39171",4287,11706,124,690,814,-7419
"1880","39173",26440,31734,642,3133,3775,-5294
"1881","39175",2484,7346,83,424,507,-4862
"1882","40001",1374,4753,NA,341,NA,-3379
"1883","40003",216,1931,NA,109,NA,-1715
"1884","40005",795,4068,NA,139,NA,-3273
"1885","40007",176,1987,NA,74,NA,-1811
"1886","40009",958,6287,NA,284,NA,-5329
"1887","4001",12196,5315,326,822,1148,6881
"1888","40011",711,2884,NA,198,NA,-2173
"1889","40013",2793,10449,NA,533,NA,-7656
"1890","40015",2418,6473,NA,445,NA,-4055
"1891","40017",11666,39969,NA,3615,NA,-28303
"1892","40019",4002,13751,NA,780,NA,-9749
"1893","40021",5455,9992,NA,1040,NA,-4537
"1894","40023",1064,4202,NA,153,NA,-3138
"1895","40025",70,962,NA,45,NA,-892
"1896","40027",38790,62469,NA,8067,NA,-23679
"1897","40029",411,1892,NA,90,NA,-1481
"1898","4003",15291,25036,798,2022,2820,-9745
"1899","40031",11439,19153,NA,1912,NA,-7714
"1900","40033",424,2054,NA,124,NA,-1630
"1901","40035",1249,4279,NA,250,NA,-3030
"1902","40037",5834,21539,NA,1413,NA,-15705
"1903","40039",2102,7818,NA,611,NA,-5716
"1904","40041",3306,11796,NA,578,NA,-8490
"1905","40043",222,1964,NA,60,NA,-1742
"1906","40045",155,1610,NA,61,NA,-1455
"1907","40047",4391,15998,NA,1303,NA,-11607
"1908","40049",1852,8243,NA,436,NA,-6391
"1909","4005",25308,16573,931,2117,3048,8735
"1910","40051",3878,17293,NA,1086,NA,-13415
"1911","40053",287,1827,NA,86,NA,-1540
"1912","40055",323,1482,NA,91,NA,-1159
"1913","40057",224,714,NA,37,NA,-490
"1914","40059",131,1307,NA,47,NA,-1176
"1915","40061",882,3697,NA,155,NA,-2815
"1916","40063",961,3387,NA,177,NA,-2426
"1917","40065",1473,5969,NA,364,NA,-4496
"1918","40067",365,1905,NA,75,NA,-1540
"1919","40069",782,3081,NA,138,NA,-2299
"1920","4007",6746,13672,204,776,980,-6926
"1921","40071",3734,12168,NA,893,NA,-8434
"1922","40073",783,5151,NA,189,NA,-4368
"1923","40075",766,2593,NA,130,NA,-1827
"1924","40077",797,3094,NA,159,NA,-2297
"1925","40079",3245,13346,NA,608,NA,-10101
"1926","40081",2423,10838,NA,740,NA,-8415
"1927","40083",4239,13613,NA,1096,NA,-9374
"1928","40085",735,2920,NA,132,NA,-2185
"1929","40087",2893,13151,NA,795,NA,-10258
"1930","40089",1799,8642,NA,268,NA,-6843
"1931","4009",3301,8025,116,497,613,-4724
"1932","40091",2122,5501,NA,335,NA,-3379
"1933","40093",310,2940,NA,149,NA,-2630
"1934","40095",1095,4202,NA,190,NA,-3107
"1935","40097",3423,11550,NA,739,NA,-8127
"1936","40099",1086,4173,NA,266,NA,-3087
"1937","40101",7969,15029,NA,1195,NA,-7060
"1938","40103",901,3707,NA,262,NA,-2806
"1939","40105",742,3321,NA,174,NA,-2579
"1940","40107",943,2791,NA,199,NA,-1848
"1941","40109",112661,141429,NA,19519,NA,-28768
"1942","4011",1092,1892,59,200,259,-800
"1943","40111",4379,8926,NA,619,NA,-4547
"1944","40113",5593,12559,NA,790,NA,-6966
"1945","40115",2584,7627,NA,475,NA,-5043
"1946","40117",1341,4716,NA,289,NA,-3375
"1947","40119",8785,16644,NA,2320,NA,-7859
"1948","4012",1318,3381,55,177,232,-2063
"1949","40121",3704,12740,NA,806,NA,-9036
"1950","40123",3633,10420,NA,761,NA,-6787
"1951","40125",6005,17826,NA,1586,NA,-11821
"1952","40127",748,3581,NA,154,NA,-2833
"1953","40129",151,1546,NA,61,NA,-1395
"1954","4013",549040,590465,13697,48732,62429,-41425
"1955","40131",7895,30893,NA,2046,NA,-22998
"1956","40133",2067,5612,NA,353,NA,-3545
"1957","40135",3061,10888,NA,488,NA,-7827
"1958","40137",3084,14166,NA,636,NA,-11082
"1959","40139",855,4615,NA,301,NA,-3760
"1960","40141",657,1944,NA,105,NA,-1287
"1961","40143",87663,143985,NA,14909,NA,-56322
"1962","40145",6711,22967,NA,1568,NA,-16256
"1963","40147",5047,15810,NA,1351,NA,-10763
"1964","40149",588,3851,NA,189,NA,-3263
"1965","4015",16485,54656,662,2386,3048,-38171
"1966","40151",521,2945,NA,199,NA,-2424
"1967","40153",871,6329,NA,373,NA,-5458
"1968","4017",15362,18165,634,1248,1882,-2803
"1969","4019",195649,147019,5029,13065,18094,48630
"1970","4021",35737,53857,965,3246,4211,-18120
"1971","4023",10684,3650,197,395,592,7034
"1972","4025",29705,58862,1144,3069,4213,-29157
"1973","4027",18336,20586,438,1399,1837,-2250
"1974","41001",1781,6160,133,405,538,-4379
"1975","41003",28431,13030,1528,2588,4116,15401
"1976","41005",90187,79062,3357,9530,12887,11125
"1977","41007",8899,7794,539,926,1465,1105
"1978","41009",9959,12967,550,1601,2151,-3008
"1979","41011",10355,17699,744,1383,2127,-7344
"1980","41013",2591,8388,155,504,659,-5797
"1981","41015",4253,7157,266,487,753,-2904
"1982","41017",40222,43667,1859,4836,6695,-3445
"1983","41019",13891,34112,988,2359,3347,-20221
"1984","41021",221,632,6,78,84,-411
"1985","41023",732,3187,47,205,252,-2455
"1986","41025",682,2904,42,222,264,-2222
"1987","41027",6359,3223,299,502,801,3136
"1988","41029",43550,53083,2908,4248,7156,-9533
"1989","41031",2892,5337,174,471,645,-2445
"1990","41033",13223,26582,1029,1779,2808,-13359
"1991","41035",7080,20170,496,1494,1990,-13090
"1992","41037",628,3001,40,145,185,-2373
"1993","41039",100497,66218,6072,8285,14357,34279
"1994","41041",12300,9901,728,1106,1834,2399
"1995","41043",17456,32683,1284,3301,4585,-15227
"1996","41045",2213,7141,174,422,596,-4928
"1997","41047",48803,54336,2170,5495,7665,-5533
"1998","41049",1004,2698,52,235,287,-1694
"1999","41051",271754,63055,11383,11570,22953,208699
"2000","41053",15741,18333,851,2105,2956,-2592
"2001","41055",202,726,11,44,55,-524
"2002","41057",5701,6486,324,750,1074,-785
"2003","41059",7466,16775,471,1404,1875,-9309
"2004","41061",3221,8378,198,668,866,-5157
"2005","41063",1097,2825,82,173,255,-1728
"2006","41065",4634,5721,231,665,896,-1087
"2007","41067",137818,75903,4979,13334,18313,61915
"2008","41069",153,583,10,46,56,-430
"2009","41071",18635,22589,952,2940,3892,-3954
"2010","42001",14077,31249,399,1222,1621,-17172
"2011","42003",363017,257488,5021,15854,20875,105529
"2012","42005",6849,22676,136,661,797,-15827
"2013","42007",30225,46081,477,1914,2391,-15856
"2014","42009",3613,19455,100,259,359,-15842
"2015","42011",75169,93094,1906,5016,6922,-17925
"2016","42013",13093,37224,325,1188,1513,-24131
"2017","42015",6263,17957,136,875,1011,-11694
"2018","42017",165861,163873,3138,8500,11638,1988
"2019","42019",26834,61388,587,2856,3443,-34554
"2020","42021",17798,40510,395,1216,1611,-22712
"2021","42023",469,1495,4,50,54,-1026
"2022","42025",8917,18714,265,686,951,-9797
"2023","42027",36555,35099,789,2609,3398,1456
"2024","42029",140188,115582,2231,7818,10049,24606
"2025","42031",4256,12545,114,466,580,-8289
"2026","42033",7700,23909,212,741,953,-16209
"2027","42035",4533,9701,119,450,569,-5168
"2028","42037",8502,17387,259,841,1100,-8885
"2029","42039",10215,23912,250,986,1236,-13697
"2030","42041",44282,65649,908,3720,4628,-21367
"2031","42043",64287,60620,1168,3459,4627,3667
"2032","42045",169169,106559,2512,5650,8162,62610
"2033","42047",3637,9704,77,371,448,-6067
"2034","42049",54820,57168,1104,3689,4793,-2348
"2035","42051",17826,34388,230,839,1069,-16562
"2036","42053",626,1680,19,60,79,-1054
"2037","42055",17322,49554,449,1689,2138,-32232
"2038","42057",904,5676,37,93,130,-4772
"2039","42059",4157,10394,80,263,343,-6237
"2040","42061",4487,14369,96,414,510,-9882
"2041","42063",11468,24920,220,924,1144,-13452
"2042","42065",3437,14533,106,404,510,-11096
"2043","42067",1810,8234,71,200,271,-6424
"2044","42069",51593,48102,889,1903,2792,3491
"2045","42071",90066,137145,1992,8437,10429,-47079
"2046","42073",13933,25323,244,860,1104,-11390
"2047","42075",17860,38804,406,1557,1963,-20944
"2048","42077",77087,70285,1338,3795,5133,6802
"2049","42079",51454,77508,1164,2287,3451,-26054
"2050","42081",12926,35475,380,1291,1671,-22549
"2051","42083",3802,11159,148,393,541,-7357
"2052","42085",17631,30034,400,1297,1697,-12403
"2053","42087",3563,14050,79,473,552,-10487
"2054","42089",31930,31706,728,1407,2135,224
"2055","42091",251063,160803,3650,10764,14414,90260
"2056","42093",2851,5274,72,287,359,-2423
"2057","42095",65936,71384,1363,3647,5010,-5448
"2058","42097",9184,24418,287,907,1194,-15234
"2059","42099",4630,15613,163,619,782,-10983
"2060","42101",560542,105418,6452,6786,13238,455124
"2061","42103",9247,16035,226,487,713,-6788
"2062","42105",1300,6247,34,165,199,-4947
"2063","42107",16724,43937,448,1406,1854,-27213
"2064","42109",3991,11710,111,451,562,-7719
"2065","42111",7367,27347,166,676,842,-19980
"2066","42113",756,2318,14,65,79,-1562
"2067","42115",5065,13295,192,559,751,-8230
"2068","42117",3642,12928,134,517,651,-9286
"2069","42119",6138,10605,141,444,585,-4467
"2070","42121",5889,15254,142,688,830,-9365
"2071","42123",4828,12032,122,525,647,-7204
"2072","42125",34436,58941,708,2553,3261,-24505
"2073","42127",6398,15269,193,420,613,-8871
"2074","42129",59506,116427,932,4323,5255,-56921
"2075","42131",3573,8375,112,305,417,-4802
"2076","42133",67428,126933,1542,6376,7918,-59505
"2077","44001",14532,8910,313,936,1249,5622
"2078","44003",37582,38141,1043,2925,3968,-559
"2079","44005",22680,14975,585,1521,2106,7705
"2080","44007",141597,90321,3158,6742,9900,51276
"2081","44009",33511,27074,1056,2519,3575,6437
"2082","45001",3712,6742,36,128,164,-3030
"2083","45003",25426,45981,459,1796,2255,-20555
"2084","45005",2722,788,11,22,33,1934
"2085","45007",21040,56109,436,1589,2025,-35069
"2086","45009",3886,2197,17,51,68,1689
"2087","45011",4395,4888,35,87,122,-493
"2088","45013",29577,39986,456,1859,2315,-10409
"2089","45015",30492,44223,539,2461,3000,-13731
"2090","45017",3569,3785,34,105,139,-216
"2091","45019",89048,75233,1673,7263,8936,13815
"2092","45021",6089,15165,80,242,322,-9076
"2093","45023",6582,7272,50,175,225,-690
"2094","45025",7125,9576,49,195,244,-2451
"2095","45027",7635,7246,27,125,152,389
"2096","45029",7616,9083,79,262,341,-1467
"2097","45031",13866,14973,133,385,518,-1107
"2098","45033",5832,5637,54,79,133,195
"2099","45035",24010,34932,446,2048,2494,-10922
"2100","45037",4491,6842,35,152,187,-2351
"2101","45039",6936,4024,48,119,167,2912
"2102","45041",26630,29498,255,850,1105,-2868
"2103","45043",13234,17334,163,497,660,-4100
"2104","45045",73338,125595,1467,6399,7866,-52257
"2105","45047",10633,16881,159,579,738,-6248
"2106","45049",5163,3483,19,69,88,1680
"2107","45051",36731,83819,777,2136,2913,-47088
"2108","45053",7789,6100,40,159,199,1689
"2109","45055",10293,17464,142,559,701,-7171
"2110","45057",13718,23598,161,760,921,-9880
"2111","45059",8845,16770,124,373,497,-7925
"2112","45061",5170,2789,22,61,83,2381
"2113","45063",35143,79866,891,3574,4465,-44723
"2114","45065",2479,2651,8,47,55,-172
"2115","45067",8522,5434,65,103,168,3088
"2116","45069",5928,4257,33,70,103,1671
"2117","45071",6212,10011,65,312,377,-3799
"2118","45073",7979,24096,224,722,946,-16117
"2119","45075",26258,11909,124,307,431,14349
"2120","45077",10327,36096,326,1189,1515,-25769
"2121","45079",108401,52753,1378,3935,5313,55648
"2122","45081",2809,5525,42,105,147,-2716
"2123","45083",39888,76101,759,2436,3195,-36213
"2124","45085",24024,18733,202,641,843,5291
"2125","45087",4727,7058,48,137,185,-2331
"2126","45089",9949,4863,50,84,134,5086
"2127","45091",41230,66245,676,3468,4144,-25015
"2128","46003",340,974,NA,74,NA,-634
"2129","46005",1912,4455,NA,323,NA,-2543
"2130","46007",412,666,NA,57,NA,-254
"2131","46009",704,2105,NA,129,NA,-1401
"2132","46011",4879,6748,NA,881,NA,-1869
"2133","46013",5452,9613,NA,915,NA,-4161
"2134","46015",571,1565,NA,125,NA,-994
"2135","46017",296,171,NA,18,NA,125
"2136","46019",693,3355,NA,246,NA,-2662
"2137","46021",105,704,NA,20,NA,-599
"2138","46023",935,2382,NA,98,NA,-1447
"2139","46025",398,1139,NA,103,NA,-741
"2140","46027",2608,2109,NA,295,NA,499
"2141","46029",3174,7764,NA,600,NA,-4590
"2142","46031",535,588,NA,34,NA,-53
"2143","46033",1120,3290,NA,255,NA,-2170
"2144","46035",2355,5157,NA,349,NA,-2802
"2145","46037",974,1627,NA,116,NA,-653
"2146","46039",570,1366,NA,117,NA,-796
"2147","46041",887,723,NA,71,NA,164
"2148","46043",214,1338,NA,41,NA,-1124
"2149","46045",380,1433,NA,86,NA,-1053
"2150","46047",821,2511,NA,166,NA,-1690
"2151","46049",204,858,NA,45,NA,-654
"2152","46051",970,2381,NA,175,NA,-1411
"2153","46053",391,1600,NA,78,NA,-1209
"2154","46055",77,936,NA,27,NA,-859
"2155","46057",555,2051,NA,124,NA,-1496
"2156","46059",334,1391,NA,76,NA,-1057
"2157","46061",424,1497,NA,59,NA,-1073
"2158","46063",38,694,NA,31,NA,-656
"2159","46065",2449,5174,NA,480,NA,-2725
"2160","46067",692,2517,NA,112,NA,-1825
"2161","46069",125,543,NA,17,NA,-418
"2162","46071",323,722,NA,36,NA,-399
"2163","46073",264,648,NA,36,NA,-384
"2164","46075",69,450,NA,32,NA,-381
"2165","46077",703,1680,NA,139,NA,-977
"2166","46079",2314,4038,NA,358,NA,-1724
"2167","46081",3356,7411,NA,934,NA,-4055
"2168","46083",8076,15499,NA,1413,NA,-7423
"2169","46085",369,977,NA,56,NA,-608
"2170","46087",623,1794,NA,130,NA,-1171
"2171","46089",192,892,NA,43,NA,-700
"2172","46091",754,1056,NA,117,NA,-302
"2173","46093",2223,8441,NA,832,NA,-6218
"2174","46095",238,402,NA,32,NA,-164
"2175","46097",281,706,NA,67,NA,-425
"2176","46099",30610,42043,NA,4753,NA,-11433
"2177","46101",1042,1729,NA,131,NA,-687
"2178","46103",14074,29804,NA,3338,NA,-15730
"2179","46105",188,1333,NA,70,NA,-1145
"2180","46107",215,1069,NA,40,NA,-854
"2181","46109",1539,2142,NA,164,NA,-603
"2182","46111",241,819,NA,51,NA,-578
"2183","46115",919,1854,NA,143,NA,-935
"2184","46117",329,1148,NA,77,NA,-819
"2185","46119",137,679,NA,40,NA,-542
"2186","46121",1505,487,NA,96,NA,1018
"2187","46123",462,2069,NA,84,NA,-1607
"2188","46125",961,2937,NA,216,NA,-1976
"2189","46127",2227,5288,NA,312,NA,-3061
"2190","46129",457,1896,NA,79,NA,-1439
"2191","46135",3301,5654,NA,551,NA,-2353
"2192","46137",352,368,NA,28,NA,-16
"2193","47001",9010,19201,189,1033,1222,-10191
"2194","47003",3384,11455,75,306,381,-8071
"2195","47005",1474,4715,14,83,97,-3241
"2196","47007",896,3621,18,95,113,-2725
"2197","47009",12085,37385,313,1661,1974,-25300
"2198","47011",7070,29761,210,1098,1308,-22691
"2199","47013",2248,9860,45,251,296,-7612
"2200","47015",1126,4006,28,106,134,-2880
"2201","47017",2323,7731,38,181,219,-5408
"2202","47019",3453,16897,130,409,539,-13444
"2203","47021",3877,11295,99,463,562,-7418
"2204","47023",902,3827,8,95,103,-2925
"2205","47025",1831,8589,29,190,219,-6758
"2206","47027",707,2140,11,47,58,-1433
"2207","47029",1980,9791,59,211,270,-7811
"2208","47031",4741,14409,113,515,628,-9668
"2209","47033",1302,3977,13,76,89,-2675
"2210","47035",5202,20410,99,471,570,-15208
"2211","47037",148473,84365,2450,9578,12028,64108
"2212","47039",894,3580,16,70,86,-2686
"2213","47041",1566,5164,49,117,166,-3598
"2214","47043",4718,13213,93,487,580,-8495
"2215","47045",2815,10175,48,193,241,-7360
"2216","47047",5865,13046,62,261,323,-7181
"2217","47049",1100,6032,37,107,144,-4932
"2218","47051",4372,11526,66,319,385,-7154
"2219","47053",5255,13779,66,304,370,-8524
"2220","47055",2915,7964,41,162,203,-5049
"2221","47057",1154,6618,27,126,153,-5464
"2222","47059",4211,18538,151,479,630,-14327
"2223","47061",998,3626,19,80,99,-2628
"2224","47063",4075,15839,93,443,536,-11764
"2225","47065",55260,78661,1097,5437,6534,-23401
"2226","47067",322,1842,13,42,55,-1520
"2227","47069",4174,4912,30,84,114,-738
"2228","47071",1622,8012,96,134,230,-6390
"2229","47073",3502,16611,90,396,486,-13109
"2230","47075",3704,3010,19,60,79,694
"2231","47077",1796,8118,39,170,209,-6322
"2232","47079",3061,9483,60,223,283,-6422
"2233","47081",1823,5685,39,161,200,-3862
"2234","47083",865,2180,12,88,100,-1315
"2235","47085",1967,4928,26,166,192,-2961
"2236","47087",1129,3229,17,62,79,-2100
"2237","47089",3490,14760,115,497,612,-11270
"2238","47091",988,5400,39,102,141,-4412
"2239","47093",62861,105724,1634,7453,9087,-42863
"2240","47095",577,1357,6,18,24,-780
"2241","47097",3656,4884,14,87,101,-1228
"2242","47099",2821,12419,77,271,348,-9598
"2243","47101",890,3579,42,59,101,-2689
"2244","47103",2550,10375,46,229,275,-7825
"2245","47105",4916,17588,87,573,660,-12672
"2246","47107",3507,14673,69,339,408,-11166
"2247","47109",1847,7839,110,150,260,-5992
"2248","47111",1071,6260,36,91,127,-5189
"2249","47113",15438,21321,140,660,800,-5883
"2250","47115",2829,7680,50,220,270,-4851
"2251","47117",2848,8167,59,255,314,-5319
"2252","47119",10026,23781,166,921,1087,-13755
"2253","47121",856,3337,19,77,96,-2481
"2254","47123",3184,13361,58,344,402,-10177
"2255","47125",21686,32320,540,2336,2876,-10634
"2256","47127",496,2325,17,71,88,-1829
"2257","47129",1053,5429,17,115,132,-4376
"2258","47131",2425,9525,36,193,229,-7100
"2259","47133",1943,6055,31,111,142,-4112
"2260","47135",597,2167,23,59,82,-1570
"2261","47137",536,2019,7,36,43,-1483
"2262","47139",1252,5097,26,114,140,-3845
"2263","47141",6847,18981,224,756,980,-12134
"2264","47143",1942,8650,35,221,256,-6708
"2265","47145",4833,15863,101,596,697,-11030
"2266","47147",6634,19393,161,717,878,-12759
"2267","47149",36627,64428,891,3910,4801,-27801
"2268","47151",934,6044,21,80,101,-5110
"2269","47153",1051,4434,25,127,152,-3383
"2270","47155",6293,28610,211,915,1126,-22317
"2271","47157",206640,114948,1955,6830,8785,91692
"2272","47159",1688,5485,30,171,201,-3797
"2273","47161",1222,3864,21,147,168,-2642
"2274","47163",11910,45577,340,1704,2044,-33667
"2275","47165",18153,50105,368,2101,2469,-31952
"2276","47167",5779,16893,90,484,574,-11114
"2277","47169",943,2099,6,72,78,-1156
"2278","47171",1260,5666,52,139,191,-4406
"2279","47173",1010,5024,24,108,132,-4014
"2280","47175",539,1820,8,46,54,-1281
"2281","47177",3535,9535,61,339,400,-6000
"2282","47179",13003,34179,478,1464,1942,-21176
"2283","47181",717,5034,9,56,65,-4317
"2284","47183",2770,9001,62,220,282,-6231
"2285","47185",1842,7657,45,149,194,-5815
"2286","47187",30992,68160,523,4510,5033,-37168
"2287","47189",14356,39304,467,1801,2268,-24948
"2288","48001",3358,13165,57,307,364,-9807
"2289","48003",836,3925,18,147,165,-3089
"2290","48005",7538,21666,106,560,666,-14128
"2291","48007",2458,7730,41,238,279,-5272
"2292","48009",394,3785,10,80,90,-3391
"2293","48011",70,924,5,18,23,-854
"2294","48013",4635,8598,65,307,372,-3963
"2295","48015",2319,9637,51,248,299,-7318
"2296","48017",397,1343,5,39,44,-946
"2297","48019",1726,8159,66,262,328,-6433
"2298","48021",10555,16314,320,1061,1381,-5759
"2299","48023",191,1267,3,31,34,-1076
"2300","48025",3443,4743,34,238,272,-1300
"2301","48027",37608,51780,811,3800,4611,-14172
"2302","48029",319191,240161,6633,20053,26686,79030
"2303","48031",1244,4212,33,180,213,-2968
"2304","48033",31,330,1,3,4,-299
"2305","48035",1277,6325,40,155,195,-5048
"2306","48037",8831,24913,144,582,726,-16082
"2307","48039",43075,72653,803,3765,4568,-29578
"2308","48041",23041,38662,532,3801,4333,-15621
"2309","48043",1869,2073,76,208,284,-204
"2310","48045",91,625,4,14,18,-534
"2311","48047",1937,613,14,32,46,1324
"2312","48049",1621,12010,65,253,318,-10389
"2313","48051",1491,5316,20,118,138,-3825
"2314","48053",3785,14595,103,563,666,-10810
"2315","48055",4663,6516,102,428,530,-1853
"2316","48057",2118,4638,33,168,201,-2520
"2317","48059",568,4858,23,107,130,-4290
"2318","48061",59319,29432,822,2231,3053,29887
"2319","48063",1260,3201,15,66,81,-1941
"2320","48065",249,2617,11,68,79,-2368
"2321","48067",2250,9182,33,141,174,-6932
"2322","48069",526,1413,10,47,57,-887
"2323","48071",2939,13278,59,385,444,-10339
"2324","48073",3466,12896,34,305,339,-9430
"2325","48075",253,1802,5,24,29,-1549
"2326","48077",536,4376,12,87,99,-3840
"2327","48079",190,679,3,29,32,-489
"2328","48081",140,1265,2,16,18,-1125
"2329","48083",387,3177,18,53,71,-2790
"2330","48085",139837,200395,2523,13790,16313,-60558
"2331","48087",145,983,4,22,26,-838
"2332","48089",1977,6323,36,144,180,-4346
"2333","48091",14166,44996,343,2062,2405,-30830
"2334","48093",788,4300,21,99,120,-3512
"2335","48095",148,885,7,27,34,-737
"2336","48097",2345,13174,60,315,375,-10829
"2337","48099",5057,12212,160,698,858,-7155
"2338","48101",84,486,2,11,13,-402
"2339","48103",299,1047,7,28,35,-748
"2340","48105",372,980,4,39,43,-608
"2341","48107",468,1180,5,59,64,-712
"2342","48109",454,280,5,23,28,174
"2343","48111",222,1258,9,46,55,-1036
"2344","48113",458845,261865,6085,23854,29939,196980
"2345","48115",835,2636,11,80,91,-1801
"2346","48117",1185,2911,14,91,105,-1726
"2347","48119",400,1836,7,36,43,-1436
"2348","48121",110000,169175,2633,11479,14112,-59175
"2349","48123",1161,5510,27,124,151,-4349
"2350","48125",128,755,3,23,26,-627
"2351","48127",2173,974,21,57,78,1199
"2352","48129",190,1225,5,40,45,-1035
"2353","48131",2783,1316,11,49,60,1467
"2354","48133",776,6008,31,120,151,-5232
"2355","48135",10225,24976,167,1005,1172,-14751
"2356","48137",302,741,5,17,22,-439
"2357","48139",16197,44807,322,1738,2060,-28610
"2358","48141",145509,54567,2914,7468,10382,90942
"2359","48143",2159,11205,68,378,446,-9046
"2360","48145",1682,3438,22,90,112,-1756
"2361","48147",2123,9536,46,267,313,-7413
"2362","48149",2127,8648,45,209,254,-6521
"2363","48151",403,1265,10,44,54,-862
"2364","48153",435,1473,3,47,50,-1038
"2365","48155",113,383,1,14,15,-270
"2366","48157",134475,117212,1782,6898,8680,17263
"2367","48159",665,3583,12,96,108,-2918
"2368","48161",1461,5995,13,139,152,-4534
"2369","48163",1401,1232,13,37,50,169
"2370","48165",597,3907,20,85,105,-3310
"2371","48167",45503,73566,885,4040,4925,-28063
"2372","48169",224,1223,7,21,28,-999
"2373","48171",2286,10445,61,331,392,-8159
"2374","48173",34,553,2,13,15,-519
"2375","48175",973,2618,21,101,122,-1645
"2376","48177",1567,4580,28,129,157,-3013
"2377","48179",699,6495,22,144,166,-5796
"2378","48181",10276,35274,263,1255,1518,-24998
"2379","48183",11623,28693,150,899,1049,-17070
"2380","48185",2194,7065,50,219,269,-4871
"2381","48187",18308,36495,409,2008,2417,-18187
"2382","48189",2090,6347,42,323,365,-4257
"2383","48191",164,891,0,34,34,-727
"2384","48193",479,3056,10,64,74,-2577
"2385","48195",171,1730,9,37,46,-1559
"2386","48197",249,1207,7,48,55,-958
"2387","48199",2779,19600,41,348,389,-16821
"2388","48201",706471,544960,11755,39701,51456,161511
"2389","48203",7130,18712,75,447,522,-11582
"2390","48205",172,1727,3,43,46,-1555
"2391","48207",314,1403,6,42,48,-1089
"2392","48209",33117,33730,1055,3622,4677,-613
"2393","48211",181,1460,2,44,46,-1279
"2394","48213",5649,23574,101,531,632,-17925
"2395","48215",118739,48608,1855,3788,5643,70131
"2396","48217",2535,10075,40,256,296,-7540
"2397","48219",1257,5793,33,199,232,-4536
"2398","48221",4001,21367,113,639,752,-17366
"2399","48223",2508,10704,44,220,264,-8196
"2400","48225",1978,6205,29,90,119,-4227
"2401","48227",1768,6635,56,233,289,-4867
"2402","48229",324,503,6,38,44,-179
"2403","48231",6301,23866,161,857,1018,-17565
"2404","48233",854,7039,23,210,233,-6185
"2405","48235",90,660,1,9,10,-570
"2406","48237",314,2973,10,42,52,-2659
"2407","48239",904,4266,27,78,105,-3362
"2408","48241",2582,10578,37,154,191,-7996
"2409","48243",422,694,17,42,59,-272
"2410","48245",42404,42828,420,1711,2131,-424
"2411","48247",1635,430,12,42,54,1205
"2412","48249",6688,5411,40,207,247,1277
"2413","48251",10976,44370,322,1602,1924,-33394
"2414","48253",935,4815,21,161,182,-3880
"2415","48255",1144,2959,12,70,82,-1815
"2416","48257",10265,29537,197,980,1177,-19272
"2417","48259",3633,15663,86,554,640,-12030
"2418","48261",99,84,0,3,3,15
"2419","48263",59,360,0,14,14,-301
"2420","48265",4665,17658,114,653,767,-12993
"2421","48267",206,1697,5,37,42,-1491
"2422","48269",5,149,0,5,5,-144
"2423","48271",457,936,6,25,31,-479
"2424","48273",4713,4364,92,314,406,349
"2425","48275",247,1078,5,28,33,-831
"2426","48277",3579,14546,69,343,412,-10967
"2427","48279",770,3040,8,87,95,-2270
"2428","48281",1479,6371,47,252,299,-4892
"2429","48283",1125,870,10,44,54,255
"2430","48285",1170,7339,12,112,124,-6169
"2431","48287",1372,4996,28,126,154,-3624
"2432","48289",909,6391,13,94,107,-5482
"2433","48291",4851,18856,84,364,448,-14005
"2434","48293",1748,5747,27,126,153,-3999
"2435","48295",135,1159,3,25,28,-1024
"2436","48297",739,3450,13,65,78,-2711
"2437","48299",1825,8283,64,205,269,-6458
"2438","48301",4,57,2,1,3,-53
"2439","48303",27956,65566,630,3908,4538,-37610
"2440","48305",403,1546,7,41,48,-1143
"2441","48307",480,2546,9,51,60,-2066
"2442","48309",27046,48245,473,2491,2964,-21199
"2443","48311",40,454,1,2,3,-414
"2444","48313",881,3349,8,45,53,-2468
"2445","48315",1156,2968,13,69,82,-1812
"2446","48317",266,1453,5,31,36,-1187
"2447","48319",353,1656,7,37,44,-1303
"2448","48321",3357,8147,49,226,275,-4790
"2449","48323",10397,2816,109,266,375,7581
"2450","48325",4624,12054,106,403,509,-7430
"2451","48327",153,681,1,25,26,-528
"2452","48329",9993,36896,203,1661,1864,-26903
"2453","48331",2042,6340,49,176,225,-4298
"2454","48333",242,1949,6,41,47,-1707
"2455","48335",353,1780,7,50,57,-1427
"2456","48337",885,7526,23,170,193,-6641
"2457","48339",45744,150188,1015,6136,7151,-104444
"2458","48341",1096,3974,26,166,192,-2878
"2459","48343",1425,3443,19,77,96,-2018
"2460","48345",40,571,0,9,9,-531
"2461","48347",6822,14751,157,700,857,-7929
"2462","48349",3998,11984,57,343,400,-7986
"2463","48351",978,2961,11,60,71,-1983
"2464","48353",1029,3551,22,142,164,-2522
"2465","48355",49102,50704,846,3306,4152,-1602
"2466","48357",274,2628,5,74,79,-2354
"2467","48359",78,850,3,14,17,-772
"2468","48361",5716,25385,115,545,660,-19669
"2469","48363",1700,8222,48,205,253,-6522
"2470","48365",1835,8445,24,109,133,-6610
"2471","48367",8329,46433,214,1437,1651,-38104
"2472","48369",848,1911,4,55,59,-1063
"2473","48371",1551,2463,26,127,153,-912
"2474","48373",7123,26587,133,601,734,-19464
"2475","48375",7620,19499,190,1021,1211,-11879
"2476","48377",1458,652,29,64,93,806
"2477","48379",619,3919,15,77,92,-3300
"2478","48381",8340,43379,227,1867,2094,-35039
"2479","48383",167,709,2,22,24,-542
"2480","48385",262,1382,6,28,34,-1120
"2481","48387",1148,3924,8,67,75,-2776
"2482","48389",1659,1417,10,98,108,242
"2483","48391",1034,1830,10,71,81,-796
"2484","48393",20,524,0,6,6,-504
"2485","48395",2203,4665,17,125,142,-2462
"2486","48397",9633,28396,207,1293,1500,-18763
"2487","48399",452,3241,13,59,72,-2789
"2488","48401",3935,14675,51,333,384,-10740
"2489","48403",614,3992,9,27,36,-3378
"2490","48405",907,2620,6,30,36,-1713
"2491","48407",2034,8050,52,169,221,-6016
"2492","48409",7825,13004,113,571,684,-5179
"2493","48411",293,2025,4,32,36,-1732
"2494","48413",209,819,2,24,26,-610
"2495","48415",733,4403,22,103,125,-3670
"2496","48417",103,1378,0,21,21,-1275
"2497","48419",1757,7171,21,123,144,-5414
"2498","48421",96,807,3,27,30,-711
"2499","48423",22128,58631,340,2062,2402,-36503
"2500","48425",540,3206,23,107,130,-2666
"2501","48427",9246,2218,68,159,227,7028
"2502","48429",348,3033,7,65,72,-2685
"2503","48431",70,549,5,9,14,-479
"2504","48433",135,555,1,10,11,-420
"2505","48435",313,1075,5,22,27,-762
"2506","48437",462,1671,6,51,57,-1209
"2507","48439",288001,345683,5401,23747,29148,-57682
"2508","48441",10047,33172,288,1759,2047,-23125
"2509","48443",140,287,0,10,10,-147
"2510","48445",424,1295,14,30,44,-871
"2511","48447",84,715,2,7,9,-631
"2512","48449",2538,6405,44,189,233,-3867
"2513","48451",9117,27376,216,1395,1611,-18259
"2514","48453",306475,126750,7420,21866,29286,179725
"2515","48455",1154,4737,11,80,91,-3583
"2516","48457",1243,6601,22,103,125,-5358
"2517","48459",2378,13198,59,283,342,-10820
"2518","48461",284,961,3,48,51,-677
"2519","48463",3863,4828,54,191,245,-965
"2520","48465",6920,5856,131,569,700,1064
"2521","48467",2792,18436,77,384,461,-15644
"2522","48469",8843,21253,154,782,936,-12410
"2523","48471",6085,12878,161,559,720,-6793
"2524","48473",5744,10525,104,342,446,-4781
"2525","48475",780,2541,10,82,92,-1761
"2526","48477",3381,10944,70,352,422,-7563
"2527","48479",42297,12946,591,1033,1624,29351
"2528","48481",4238,10149,51,269,320,-5911
"2529","48483",194,2087,4,21,25,-1893
"2530","48485",8752,27609,256,1296,1552,-18857
"2531","48487",807,3166,13,115,128,-2359
"2532","48489",3416,1541,31,94,125,1875
"2533","48491",84252,104029,2038,10205,12243,-19777
"2534","48493",4790,13991,82,392,474,-9201
"2535","48495",420,1403,1,49,50,-983
"2536","48497",3412,20655,91,503,594,-17243
"2537","48499",2624,15681,64,277,341,-13057
"2538","48501",426,1797,3,73,76,-1371
"2539","48503",873,6587,19,179,198,-5714
"2540","48505",2056,1028,16,34,50,1028
"2541","48507",2633,692,16,49,65,1941
"2542","49001",264,1838,10,36,46,-1574
"2543","49003",1814,10324,59,513,572,-8510
"2544","49005",5435,12385,164,804,968,-6950
"2545","49007",1673,5055,39,184,223,-3382
"2546","49009",76,327,0,17,17,-251
"2547","49011",20206,41250,492,3387,3879,-21044
"2548","49013",500,5505,18,107,125,-5005
"2549","49015",379,3402,3,70,73,-3023
"2550","49017",352,1577,14,60,74,-1225
"2551","49019",1920,1924,107,175,282,-4
"2552","49021",977,4090,33,147,180,-3113
"2553","49023",436,2759,14,70,84,-2323
"2554","49025",739,2248,31,86,117,-1509
"2555","49027",429,3845,6,107,113,-3416
"2556","49029",572,3156,10,140,150,-2584
"2557","49031",31,537,1,10,11,-506
"2558","49033",104,786,1,21,22,-682
"2559","49035",126702,91375,2659,9834,12493,35327
"2560","49037",1143,2073,26,104,130,-930
"2561","49039",1026,6436,27,178,205,-5410
"2562","49041",648,6146,27,165,192,-5498
"2563","49043",10251,7160,162,736,898,3091
"2564","49045",4015,9693,148,672,820,-5678
"2565","49047",988,9745,44,268,312,-8757
"2566","49049",22934,84863,812,5132,5944,-61929
"2567","49051",2800,5627,64,373,437,-2827
"2568","49053",8369,33472,215,1121,1336,-25103
"2569","49055",271,959,10,17,27,-688
"2570","49057",22187,38447,876,3201,4077,-16260
"2571","50001",11217,5297,361,638,999,5920
"2572","50003",9539,5925,318,478,796,3614
"2573","50005",6445,5533,333,578,911,912
"2574","50007",54463,18298,1788,2443,4231,36165
"2575","50009",1019,1506,43,121,164,-487
"2576","5001",1939,3825,64,126,190,-1886
"2577","50011",9351,8752,320,836,1156,599
"2578","50013",2094,1487,49,131,180,607
"2579","50015",7241,3570,326,457,783,3671
"2580","50017",7522,4997,350,509,859,2525
"2581","50019",5181,5158,193,398,591,23
"2582","50021",13629,12471,467,946,1413,1158
"2583","50023",18594,7993,911,999,1910,10601
"2584","50025",14340,5462,677,582,1259,8878
"2585","50027",17544,8604,612,931,1543,8940
"2586","5003",2408,5338,34,156,190,-2930
"2587","5005",4163,14655,138,451,589,-10492
"2588","5007",27894,60751,946,3856,4802,-32857
"2589","5009",2925,12225,134,379,513,-9300
"2590","5011",1317,2163,16,73,89,-846
"2591","5013",636,1554,3,44,47,-918
"2592","5015",3334,6773,210,237,447,-3439
"2593","5017",2350,1716,15,35,50,634
"2594","5019",3606,4398,68,196,264,-792
"2595","5021",1999,3779,35,100,135,-1780
"2596","5023",2101,9454,63,229,292,-7353
"2597","5025",723,2460,8,59,67,-1737
"2598","5027",3140,5456,40,117,157,-2316
"2599","5029",2655,4844,43,171,214,-2189
"2600","5031",10474,22798,303,1026,1329,-12324
"2601","5033",4476,16655,173,578,751,-12179
"2602","5035",8368,6953,95,242,337,1415
"2603","5037",1995,4577,24,105,129,-2582
"2604","5039",1165,1507,12,26,38,-342
"2605","5041",2227,1915,4,44,48,312
"2606","5043",2364,3967,43,108,151,-1603
"2607","5045",14525,29170,507,1639,2146,-14645
"2608","5047",1376,5034,34,177,211,-3658
"2609","5049",1067,3470,41,107,148,-2403
"2610","5051",12283,26053,387,984,1371,-13770
"2611","5053",1407,5160,30,175,205,-3753
"2612","5055",3056,10698,97,401,498,-7642
"2613","5057",2371,4391,22,105,127,-2020
"2614","5059",3137,8153,112,237,349,-5016
"2615","5061",1350,3155,22,60,82,-1805
"2616","5063",2878,9925,85,350,435,-7047
"2617","5065",1111,4042,45,125,170,-2931
"2618","5067",1583,3262,26,111,137,-1679
"2619","5069",15721,9231,156,294,450,6490
"2620","5071",2421,6072,90,293,383,-3651
"2621","5073",1028,1750,5,26,31,-722
"2622","5075",1263,4064,39,165,204,-2801
"2623","5077",1735,1229,6,16,22,506
"2624","5079",1252,2455,16,48,64,-1203
"2625","5081",1397,3604,14,85,99,-2207
"2626","5083",1712,5737,54,195,249,-4025
"2627","5085",5638,19902,170,760,930,-14264
"2628","5087",1587,4917,54,144,198,-3330
"2629","5089",1377,5077,53,150,203,-3700
"2630","5091",4273,11293,69,237,306,-7020
"2631","5093",5621,6988,64,176,240,-1367
"2632","5095",1298,1400,9,35,44,-102
"2633","5097",735,2573,32,50,82,-1838
"2634","5099",1156,2001,6,35,41,-845
"2635","51001",6737,8582,62,262,324,-1845
"2636","51003",33297,19232,448,2100,2548,14065
"2637","51005",2165,4873,35,164,199,-2708
"2638","51007",2150,4704,11,129,140,-2554
"2639","51009",4986,9643,64,313,377,-4657
"2640","5101",699,2875,69,49,118,-2176
"2641","51011",2023,5714,31,136,167,-3691
"2642","51013",91879,20155,908,3816,4724,71724
"2643","51015",8108,26152,200,1599,1799,-18044
"2644","51017",603,1548,14,56,70,-945
"2645","51019",9733,30578,176,1073,1249,-20845
"2646","51021",453,2572,17,61,78,-2119
"2647","51023",4492,13369,101,495,596,-8877
"2648","51025",4473,3045,25,72,97,1428
"2649","51027",1721,7292,26,122,148,-5571
"2650","51029",3128,3969,27,102,129,-841
"2651","5103",4320,5347,24,97,121,-1027
"2652","51031",6597,19442,102,658,760,-12845
"2653","51033",6425,7143,99,368,467,-718
"2654","51035",2557,10653,69,220,289,-8096
"2655","51036",2244,1381,21,65,86,863
"2656","51037",2153,3479,11,111,122,-1326
"2657","51041",80993,84938,989,6241,7230,-3945
"2658","51043",3047,4657,55,261,316,-1610
"2659","51045",541,2139,20,54,74,-1598
"2660","51047",7744,13341,176,584,760,-5597
"2661","51049",2032,2693,24,94,118,-661
"2662","5105",1035,2979,38,112,150,-1944
"2663","51051",1335,4932,14,81,95,-3597
"2664","51053",5765,7447,46,196,242,-1682
"2665","51057",2541,2657,18,113,131,-116
"2666","51059",354485,157837,4551,15649,20200,196648
"2667","51061",12960,22110,267,1190,1457,-9150
"2668","51063",2300,5289,107,185,292,-2989
"2669","51065",5751,7018,80,425,505,-1267
"2670","51067",7254,18560,115,602,717,-11306
"2671","51069",11920,26069,323,1278,1601,-14149
"2672","5107",4292,2443,20,62,82,1849
"2673","51071",1949,5930,39,201,240,-3981
"2674","51073",5399,13087,134,691,825,-7688
"2675","51075",4884,8374,53,474,527,-3490
"2676","51077",1407,5593,55,110,165,-4186
"2677","51079",2923,5943,66,405,471,-3020
"2678","51081",2558,1737,6,50,56,821
"2679","51083",6890,9698,44,237,281,-2808
"2680","51085",19360,39592,314,2307,2621,-20232
"2681","51087",93615,59674,1091,5595,6686,33941
"2682","51089",8199,15207,98,378,476,-7008
"2683","5109",684,3150,8,73,81,-2466
"2684","51091",371,958,8,33,41,-587
"2685","51093",7673,11971,78,562,640,-4298
"2686","51095",19091,21284,281,1395,1676,-2193
"2687","51097",1451,2059,18,75,93,-608
"2688","51099",4002,7338,83,367,450,-3336
"2689","51101",2752,5963,42,260,302,-3211
"2690","51103",2862,3520,35,141,176,-658
"2691","51105",1627,7542,33,106,139,-5915
"2692","51107",99909,69633,1294,6051,7345,30276
"2693","51109",6208,10507,124,505,629,-4299
"2694","5111",1878,3149,34,106,140,-1271
"2695","51111",2226,3206,25,88,113,-980
"2696","51113",2202,4418,43,184,227,-2216
"2697","51115",1563,3515,31,147,178,-1952
"2698","51117",6571,8283,30,239,269,-1712
"2699","51119",2107,3668,33,140,173,-1561
"2700","51121",20015,19455,401,2026,2427,560
"2701","51125",3677,4150,81,240,321,-473
"2702","51127",3545,8117,52,347,399,-4572
"2703","5113",1210,6606,56,163,219,-5396
"2704","51131",3255,2686,40,116,156,569
"2705","51133",2830,5089,20,177,197,-2259
"2706","51135",2829,3712,25,116,141,-883
"2707","51137",5955,10511,115,398,513,-4556
"2708","51139",2514,7824,38,198,236,-5310
"2709","51141",1768,6454,49,147,196,-4686
"2710","51143",9195,21742,106,442,548,-12547
"2711","51145",4057,11875,73,639,712,-7818
"2712","51147",4590,4099,53,286,339,491
"2713","51149",6419,9157,70,374,444,-2738
"2714","5115",4818,15694,216,592,808,-10876
"2715","51153",83093,54065,1231,4209,5440,29028
"2716","51155",4170,10314,107,350,457,-6144
"2717","51157",1741,2532,36,93,129,-791
"2718","51159",1347,2213,13,57,70,-866
"2719","51161",16787,30857,278,1557,1835,-14070
"2720","51163",3506,6671,66,271,337,-3165
"2721","51165",9361,25269,208,1088,1296,-15908
"2722","51167",2328,9516,58,189,247,-7188
"2723","51169",1579,8242,39,142,181,-6663
"2724","5117",812,2503,10,56,66,-1691
"2725","51171",5269,14078,147,555,702,-8809
"2726","51173",2661,9747,52,257,309,-7086
"2727","51175",3595,5035,27,156,183,-1440
"2728","51177",24204,34619,450,1910,2360,-10415
"2729","51179",27879,33840,488,2137,2625,-5961
"2730","51181",2069,1785,16,78,94,284
"2731","51183",2874,2055,22,63,85,819
"2732","51185",2895,15160,54,260,314,-12265
"2733","51187",5165,11762,149,493,642,-6597
"2734","5119",89377,61182,1549,4320,5869,28195
"2735","51191",5548,19309,93,536,629,-13761
"2736","51193",3723,4331,37,151,188,-608
"2737","51195",2687,11983,77,179,256,-9296
"2738","51197",2765,10044,49,285,334,-7279
"2739","51199",12989,18823,327,1384,1711,-5834
"2740","5121",1425,4508,53,203,256,-3083
"2741","5123",4031,3195,18,64,82,836
"2742","5125",13247,35852,826,1464,2290,-22605
"2743","5127",507,2378,21,70,91,-1871
"2744","5129",601,2955,18,68,86,-2354
"2745","5131",12184,28769,476,1605,2081,-16585
"2746","5133",1075,3281,20,83,103,-2206
"2747","5135",1472,5405,49,154,203,-3933
"2748","5137",1189,4081,61,117,178,-2892
"2749","5139",5667,10201,69,263,332,-4534
"2750","5141",1547,5382,2,82,84,-3835
"2751","5143",32296,40418,1275,3280,4555,-8122
"2752","5145",5157,21038,151,695,846,-15881
"2753","5147",1117,1344,11,45,56,-227
"2754","5149",1472,4600,47,157,204,-3128
"2755","51510",57147,13241,589,2016,2605,43906
"2756","51520",1832,4884,50,136,186,-3052
"2757","51530",693,1432,13,83,96,-739
"2758","51540",17865,2951,230,784,1014,14914
"2759","51550",52554,53988,698,3453,4151,-1434
"2760","51570",2367,5681,44,247,291,-3314
"2761","51580",914,1349,8,73,81,-435
"2762","51590",11051,7306,73,315,388,3745
"2763","51595",1531,792,10,26,36,739
"2764","51600",7363,3695,106,427,533,3668
"2765","51610",5810,1323,70,236,306,4487
"2766","51620",2516,1421,16,72,88,1095
"2767","51630",6690,3731,137,388,525,2959
"2768","51640",680,1603,7,45,52,-923
"2769","51650",41030,17802,472,1641,2113,23228
"2770","51660",10100,6232,252,800,1052,3868
"2771","51670",4722,3885,58,212,270,837
"2772","51678",1514,766,20,92,112,748
"2773","51680",14787,17979,207,1378,1585,-3192
"2774","51683",8395,5934,147,487,634,2461
"2775","51685",3218,1732,45,162,207,1486
"2776","51690",3531,2149,29,113,142,1382
"2777","51700",40997,23650,550,2373,2923,17347
"2778","51710",51429,19875,740,2439,3179,31554
"2779","51720",383,1021,6,24,30,-638
"2780","51730",12005,1448,67,139,206,10557
"2781","51735",1599,5089,43,307,350,-3490
"2782","51740",28462,12773,340,1094,1434,15689
"2783","51750",2923,2637,58,301,359,286
"2784","51760",74640,14254,1083,3706,4789,60386
"2785","51770",23403,16045,429,1400,1829,7358
"2786","51775",4212,7225,92,442,534,-3013
"2787","51790",5329,5129,109,419,528,200
"2788","51800",23012,17206,214,1075,1289,5806
"2789","51810",76744,84389,1566,7208,8774,-7645
"2790","51820",3762,4798,74,335,409,-1036
"2791","51830",5199,1921,84,230,314,3278
"2792","51840",5161,4786,99,400,499,375
"2793","53001",1118,2740,18,156,174,-1622
"2794","53003",3118,5712,116,619,735,-2594
"2795","53005",23160,42071,660,3976,4636,-18911
"2796","53007",8402,11556,223,733,956,-3154
"2797","53009",13733,13741,438,1095,1533,-8
"2798","53011",88507,88266,3060,9389,12449,241
"2799","53013",482,1359,24,83,107,-877
"2800","53015",15296,20216,545,1695,2240,-4920
"2801","53017",3452,6875,96,445,541,-3423
"2802","53019",960,1927,46,149,195,-967
"2803","53021",5594,8242,110,620,730,-2648
"2804","53023",276,841,14,87,101,-565
"2805","53025",7400,17813,283,1318,1601,-10413
"2806","53027",10194,11818,438,1111,1549,-1624
"2807","53029",20173,17634,748,2147,2895,2539
"2808","53031",11987,5716,646,683,1329,6271
"2809","53033",638033,191806,14180,34865,49045,446227
"2810","53035",57049,43265,1895,7257,9152,13784
"2811","53037",5452,7530,184,516,700,-2078
"2812","53039",3196,4436,127,293,420,-1240
"2813","53041",5750,12503,201,716,917,-6753
"2814","53043",1222,4056,49,243,292,-2834
"2815","53045",11598,13256,512,1485,1997,-1658
"2816","53047",2630,4048,86,228,314,-1418
"2817","53049",3900,4444,140,319,459,-544
"2818","53051",1871,4227,95,300,395,-2356
"2819","53053",148918,125964,4809,16305,21114,22954
"2820","53055",6735,2523,411,350,761,4212
"2821","53057",17905,15541,498,1551,2049,2364
"2822","53059",2098,2789,123,247,370,-691
"2823","53061",165740,114775,5310,16902,22212,50965
"2824","53063",83941,100669,3398,11340,14738,-16728
"2825","53065",3477,8463,115,479,594,-4986
"2826","53067",62130,44320,2948,6482,9430,17810
"2827","53069",824,1328,50,110,160,-504
"2828","53071",6260,8869,172,701,873,-2609
"2829","53073",57197,38985,2757,4479,7236,18212
"2830","53075",3903,3732,112,465,577,171
"2831","53077",20039,29592,379,1840,2219,-9553
"2832","54001",1213,4509,63,212,275,-3296
"2833","54003",12287,28210,470,1617,2087,-15923
"2834","54005",1783,6483,69,246,315,-4700
"2835","54007",1315,3516,47,157,204,-2201
"2836","54009",2549,6574,98,296,394,-4025
"2837","54011",11306,19648,388,1182,1570,-8342
"2838","54013",456,2023,44,63,107,-1567
"2839","54015",566,2289,24,60,84,-1723
"2840","54017",360,2347,37,64,101,-1987
"2841","54019",4246,10263,179,434,613,-6017
"2842","54021",537,1889,24,68,92,-1352
"2843","54023",510,4338,21,65,86,-3828
"2844","54025",3743,9499,200,472,672,-5756
"2845","54027",1576,6646,103,195,298,-5070
"2846","54029",3247,8870,122,367,489,-5623
"2847","54031",1249,4544,45,149,194,-3295
"2848","54033",7675,18687,326,1035,1361,-11012
"2849","54035",2648,8959,106,302,408,-6311
"2850","54037",9458,13144,326,992,1318,-3686
"2851","54039",27985,43464,805,2476,3281,-15479
"2852","54041",1336,5245,69,207,276,-3909
"2853","54043",1435,5257,62,187,249,-3822
"2854","54045",2082,9866,84,235,319,-7784
"2855","54047",1429,4614,27,90,117,-3185
"2856","54049",6926,14592,367,894,1261,-7666
"2857","54051",2894,9565,151,414,565,-6671
"2858","54053",2069,7597,86,275,361,-5528
"2859","54055",4689,17362,207,549,756,-12673
"2860","54057",2019,8957,120,276,396,-6938
"2861","54059",1365,7876,31,145,176,-6511
"2862","54061",14568,18278,806,1807,2613,-3710
"2863","54063",1089,4337,54,147,201,-3248
"2864","54065",1568,5718,103,208,311,-4150
"2865","54067",1821,7169,82,279,361,-5348
"2866","54069",5452,11077,382,738,1120,-5625
"2867","54071",726,2388,18,73,91,-1662
"2868","54073",620,2342,20,120,140,-1722
"2869","54075",924,2474,57,149,206,-1550
"2870","54077",2462,9501,130,427,557,-7039
"2871","54079",5784,17455,262,811,1073,-11671
"2872","54081",6362,21835,252,675,927,-15473
"2873","54083",2724,7583,93,338,431,-4859
"2874","54085",490,3376,40,105,145,-2886
"2875","54087",1220,3772,65,141,206,-2552
"2876","54089",1186,3444,57,137,194,-2258
"2877","54091",1483,4701,77,194,271,-3218
"2878","54093",750,2557,46,101,147,-1807
"2879","54095",505,2967,25,102,127,-2462
"2880","54097",1763,6971,88,310,398,-5208
"2881","54099",3334,11077,119,420,539,-7743
"2882","54101",554,2284,30,79,109,-1730
"2883","54103",1348,4461,65,242,307,-3113
"2884","54105",383,1903,23,84,107,-1520
"2885","54107",8327,25168,367,1251,1618,-16841
"2886","54109",1061,6527,38,136,174,-5466
"2887","55001",3780,5983,80,207,287,-2203
"2888","55003",4136,3428,140,182,322,708
"2889","55005",7881,13595,169,726,895,-5714
"2890","55007",4953,4125,185,186,371,828
"2891","55009",53358,67192,1371,4982,6353,-13834
"2892","55011",2531,4049,74,218,292,-1518
"2893","55013",2948,5412,67,229,296,-2464
"2894","55015",9634,15345,204,1052,1256,-5711
"2895","55017",11875,17912,264,1207,1471,-6037
"2896","55019",4225,8645,107,446,553,-4420
"2897","55021",13525,14160,347,1092,1439,-635
"2898","55023",3426,3844,73,277,350,-418
"2899","55025",217506,71270,4314,10544,14858,146236
"2900","55027",13968,26643,361,1539,1900,-12675
"2901","55029",8026,8584,145,558,703,-558
"2902","55031",11342,9657,337,723,1060,1685
"2903","55033",9025,11487,297,1094,1391,-2462
"2904","55035",27271,23301,699,2500,3199,3970
"2905","55037",666,1897,17,64,81,-1231
"2906","55039",17391,31044,449,1910,2359,-13653
"2907","55041",1583,2787,36,80,116,-1204
"2908","55043",10047,12347,308,1167,1475,-2300
"2909","55045",9121,8693,196,687,883,428
"2910","55047",2700,6210,74,274,348,-3510
"2911","55049",6669,4809,112,456,568,1860
"2912","55051",1273,2090,31,72,103,-817
"2913","55053",3821,4907,105,300,405,-1086
"2914","55055",16559,23409,462,1660,2122,-6850
"2915","55057",4100,7188,106,286,392,-3088
"2916","55059",35770,36025,867,2731,3598,-255
"2917","55061",3623,6616,79,348,427,-2993
"2918","55063",32402,26384,920,2673,3593,6018
"2919","55065",3288,3977,49,238,287,-689
"2920","55067",3260,6436,66,279,345,-3176
"2921","55069",5370,8400,114,595,709,-3030
"2922","55071",14563,23234,347,1559,1906,-8671
"2923","55073",26476,39010,641,2330,2971,-12534
"2924","55075",6243,12995,131,507,638,-6752
"2925","55077",2808,4712,50,187,237,-1904
"2926","55078",1003,269,7,0,7,734
"2927","55079",288986,126091,4534,13589,18123,162895
"2928","55081",7047,11442,229,701,930,-4395
"2929","55083",5886,13255,114,569,683,-7369
"2930","55085",8103,11677,191,751,942,-3574
"2931","55087",38117,51579,983,3905,4888,-13462
"2932","55089",20167,30458,387,2111,2498,-10291
"2933","55091",1345,2228,33,115,148,-883
"2934","55093",8380,11260,281,1044,1325,-2880
"2935","55095",7568,13864,232,886,1118,-6296
"2936","55097",18524,17310,583,1490,2073,1214
"2937","55099",2671,4562,83,199,282,-1891
"2938","55101",42506,46620,834,3246,4080,-4114
"2939","55103",3577,4021,107,219,326,-444
"2940","55105",39336,31483,885,2859,3744,7853
"2941","55107",2171,4564,56,189,245,-2393
"2942","55109",17496,26123,513,2338,2851,-8627
"2943","55111",16050,15871,472,1208,1680,179
"2944","55113",2846,4625,78,188,266,-1779
"2945","55115",6056,12742,160,603,763,-6686
"2946","55117",22636,32368,538,2320,2858,-9732
"2947","55119",2398,6589,67,279,346,-4191
"2948","55121",5645,7370,114,372,486,-1725
"2949","55123",6351,6994,296,447,743,-643
"2950","55125",4769,8169,116,340,456,-3400
"2951","55127",18706,28848,612,2116,2728,-10142
"2952","55129",3283,5404,74,267,341,-2121
"2953","55131",20854,51729,548,2745,3293,-30875
"2954","55133",79199,145519,1674,8890,10564,-66320
"2955","55135",8303,16013,237,793,1030,-7710
"2956","55137",3802,7669,93,314,407,-3867
"2957","55139",37054,43447,1063,3820,4883,-6393
"2958","55141",14232,21502,392,1364,1756,-7270
"2959","56001",6888,7601,344,1391,1735,-713
"2960","56003",594,4067,35,250,285,-3473
"2961","56005",1324,15778,66,653,719,-14454
"2962","56007",1279,4409,49,381,430,-3130
"2963","56009",668,5520,42,251,293,-4852
"2964","56011",271,3347,11,118,129,-3076
"2965","56013",4200,11167,233,773,1006,-6967
"2966","56015",924,4418,45,234,279,-3494
"2967","56017",400,1939,35,136,171,-1539
"2968","56019",638,3477,33,174,207,-2839
"2969","56021",11572,24844,434,2656,3090,-13272
"2970","56023",1105,6779,46,331,377,-5674
"2971","56025",6573,23523,310,1787,2097,-16950
"2972","56027",115,1116,7,49,56,-1001
"2973","56029",2535,11115,151,625,776,-8580
"2974","56031",719,3437,36,180,216,-2718
"2975","56033",2926,10266,158,729,887,-7340
"2976","56035",644,3409,28,169,197,-2765
"2977","56037",3233,12153,152,928,1080,-8920
"2978","56039",7313,3920,172,701,873,3393
"2979","56041",1202,6154,79,472,551,-4952
"2980","56043",532,2911,37,194,231,-2379
"2981","56045",294,2898,9,103,112,-2604
"2982","6001",337524,64010,10458,10568,21026,273514
"2983","6003",318,211,21,22,43,107
"2984","6005",3420,6069,98,441,539,-2649
"2985","6007",31638,35354,1728,3205,4933,-3716
"2986","6009",6740,11064,309,871,1180,-4324
"2987","6011",2484,3425,75,240,315,-941
"2988","6013",231968,87211,5564,11497,17061,144757
"2989","6015",2997,4370,185,330,515,-1373
"2990","6017",28026,37286,914,3477,4391,-9260
"2991","6019",98103,94005,2780,6245,9025,4098
"2992","6021",1766,3405,55,192,247,-1639
"2993","6023",19596,10883,1800,1167,2967,8713
"2994","6025",14331,5607,298,500,798,8724
"2995","6027",3067,4128,203,318,521,-1061
"2996","6029",64980,95064,1663,6087,7750,-30084
"2997","6031",9077,13158,246,870,1116,-4081
"2998","6033",6240,5752,457,533,990,488
"2999","6035",2026,6533,92,398,490,-4507
"3000","6037",1654626,542591,46682,56905,103587,1112035
"3001","6039",13283,19221,470,1161,1631,-5938
"3002","6041",69518,14214,1748,2425,4173,55304
"3003","6043",2568,4317,140,274,414,-1749
"3004","6045",6905,3571,525,400,925,3334
"3005","6047",21856,18486,578,1345,1923,3370
"3006","6049",798,2413,41,98,139,-1615
"3007","6051",2551,1989,128,220,348,562
"3008","6053",47387,19580,1316,2242,3558,27807
"3009","6055",20454,9335,469,1189,1658,11119
"3010","6057",16199,14686,992,1338,2330,1513
"3011","6059",413982,371268,10741,31103,41844,42714
"3012","6061",43915,55212,1208,4694,5902,-11297
"3013","6063",3224,5079,153,351,504,-1855
"3014","6065",253215,240013,6523,15427,21950,13202
"3015","6067",217211,133829,5639,15202,20841,83382
"3016","6069",6751,4358,175,407,582,2393
"3017","6071",258409,214698,7410,15472,22882,43711
"3018","6073",429338,298521,11005,27799,38804,130817
"3019","6075",238772,27633,6412,5922,12334,211139
"3020","6077",71349,56194,1583,4483,6066,15155
"3021","6079",53911,44981,2018,4787,6805,8930
"3022","6081",163084,40809,3036,6136,9172,122275
"3023","6083",85147,45788,2716,5198,7914,39359
"3024","6085",406049,116196,9266,19779,29045,289853
"3025","6087",60529,14523,2371,2512,4883,46006
"3026","6089",17483,40447,905,2420,3325,-22964
"3027","6091",596,1044,40,96,136,-448
"3028","6093",5252,8392,354,577,931,-3140
"3029","6095",87419,45641,2245,5264,7509,41778
"3030","6097",116027,37421,4321,5846,10167,78606
"3031","6099",51171,52567,1361,3922,5283,-1396
"3032","6101",7599,10947,194,768,962,-3348
"3033","6103",5120,11429,175,652,827,-6309
"3034","6105",1876,2409,173,240,413,-533
"3035","6107",23663,33372,681,1804,2485,-9709
"3036","6109",7075,10614,227,735,962,-3539
"3037","6111",143095,101351,4194,9768,13962,41744
"3038","6113",34460,13178,925,1864,2789,21282
"3039","6115",5115,8869,225,606,831,-3754
"3040","8001",86471,73807,2248,8640,10888,12664
"3041","8003",3168,3031,117,399,516,137
"3042","8005",148365,109638,3397,14472,17869,38727
"3043","8007",2489,4234,116,328,444,-1745
"3044","8009",278,1716,17,49,66,-1438
"3045","8011",581,1166,19,80,99,-585
"3046","8013",124715,38766,3370,7395,10765,85949
"3047","8014",19530,14272,487,2146,2633,5258
"3048","8015",4773,5283,190,523,713,-510
"3049","8017",127,905,4,30,34,-778
"3050","8019",2585,2426,107,342,449,159
"3051","8021",1753,1885,24,163,187,-132
"3052","8023",1109,581,19,80,99,528
"3053","8025",336,1069,10,62,72,-733
"3054","8027",797,2059,24,141,165,-1262
"3055","8029",4048,11584,250,466,716,-7536
"3056","8031",174611,43637,2970,8609,11579,130974
"3057","8033",227,936,13,29,42,-709
"3058","8035",67045,100178,1406,9832,11238,-33133
"3059","8037",12652,8153,343,1163,1506,4499
"3060","8039",3056,11536,133,636,769,-8480
"3061","8041",105807,176506,3952,19408,23360,-70699
"3062","8043",5275,15066,238,881,1119,-9791
"3063","8045",11205,13071,467,1124,1591,-1866
"3064","8047",1634,1564,122,194,316,70
"3065","8049",3319,4467,125,481,606,-1148
"3066","8051",5068,3250,247,585,832,1818
"3067","8053",197,339,11,27,38,-142
"3068","8055",1631,1875,48,150,198,-244
"3069","8057",171,628,7,41,48,-457
"3070","8059",151885,130233,4090,16934,21024,21652
"3071","8061",91,726,1,24,25,-635
"3072","8063",526,2894,15,92,107,-2368
"3073","8065",1600,1264,77,172,249,336
"3074","8067",15300,12471,637,1834,2471,2829
"3075","8069",92170,82624,3121,11322,14443,9546
"3076","8071",2614,3656,57,246,303,-1042
"3077","8073",399,1873,9,75,84,-1474
"3078","8075",1843,7272,65,317,382,-5429
"3079","8077",20958,48129,672,3440,4112,-27171
"3080","8079",237,344,11,42,53,-107
"3081","8081",874,5293,31,177,208,-4419
"3082","8083",3920,7771,231,531,762,-3851
"3083","8085",5438,14303,137,729,866,-8865
"3084","8087",3128,8104,80,344,424,-4976
"3085","8089",1719,2988,26,182,208,-1269
"3086","8091",1690,1337,60,149,209,353
"3087","8093",3351,6053,165,496,661,-2702
"3088","8095",436,1791,9,60,69,-1355
"3089","8097",7239,2522,181,366,547,4717
"3090","8099",1173,3508,30,154,184,-2335
"3091","8101",27945,27746,602,2760,3362,199
"3092","8103",433,2782,16,117,133,-2349
"3093","8105",1985,3060,61,229,290,-1075
"3094","8107",7487,5149,199,710,909,2338
"3095","8109",1345,1109,122,85,207,236
"3096","8111",265,215,4,17,21,50
"3097","8113",2960,1030,128,154,282,1930
"3098","8115",267,1015,21,28,49,-748
"3099","8117",9502,5064,300,983,1283,4438
"3100","8119",3547,9580,160,660,820,-6033
"3101","8121",289,2284,11,81,92,-1995
"3102","8123",45869,75882,1321,7352,8673,-30013
"3103","8125",701,3755,16,113,129,-3054
"3104","9001",238723,155457,4761,11338,16099,83266
"3105","9003",233789,147912,5683,11835,17518,85877
"3106","9005",39836,53376,1364,2858,4222,-13540
"3107","9007",45306,38847,1495,2754,4249,6459
"3108","9009",203601,158373,4802,9133,13935,45228
"3109","9011",62951,54574,2228,4774,7002,8377
"3110","9013",38450,33989,1451,3179,4630,4461
"3111","9015",21776,25738,1009,2180,3189,-3962
